mitqut	(mitq)+ut
aulattijuq	(aulatti)+juq
hivunikhaqhiuqtuq	hivun+(i)+khaq+hiuq+tuq
hunak	(huna)+k
qitun’raq	qi+(tun’r)+aq
uunaqun	(uunaq)+un
kigiqtuq	(kig)+iqtuq
aahivak	a+(ahi)+vak
qijualiuqtuq	qi+(jua)+liuq+tuq
tuktuvallak	(tuktuva)+llak
kilgavikpak	ki+(lgavik)+pak
haumingni	(haumi)+ngni
kanguujaq	kang+(uuj)+aq
kihimngiurumajuq	ki+(himngiuruma)+juq
sikiituuqtuq	(sikii)+tuuq+tuq
qagaaqtuq	(qaga)+aq+tuq
nangiqtuq	(nang)+iqtuq
iniqtuq	(iniq)+tuq
nauttiaq	(nau)+ttiaq
pulaaqtuq	(pula)+aq+tuq
atuqtuujaqtuq	(atuqtuuj)+aq+tuq
kigutigikhaqtuq	kigu+(tigikh)+aq+tuq
aniqhaumijaaqtuq	a+(niqhaumija)+aq+tuq
uhiaruti	(uhiar)+uti
piannaqtuq	(pian)+naq+tuq
anuraaqtuq	(anura)+aq+tuq
nipiliurut	(nipiliur)+ut
qiamiqhuqtaa	qi+(amiqh)+uq+taa
akuliariktuq	(akulia)+rik+tuq
tipigikhaun	(tipigikha)+un
atan’ngujaq	a+(tan’nguj)+aq
hikulihaaq	hi+(kuli)+haaq
kuugaq	(kuuga)+q
tikitinnata	(tikitinna)+ta
tipaakuun	(tipaaku)+un
tulimaaq	t+(ulima)+aq
imitqutailaq	(imitqutail)+aq
pulgiq	p+(ulg)+iq
nuvalqhiq	(nuvalq)+hiq
arnaqtuqtuq	(arnaq)+tuq+tuq
atpa	(at)+pa
imiarjiraqtuq	(imiarjir)+aq+tuq
hanimun	(hanim)+un
aqajat	a+(qaja)+t
qapuk	qa+(pu)+k
tikitinnagit	(tikitinna)+git
iliharvigijaa	(iliharvi)+gijaa
pualrittit	(pualri)+ttit
aupajaavjaktuq	(aupajaavjak)+tuq
hukkijaaqtuq	hu+(kkija)+aq+tuq
paan’ruqtuq	paa+(n’ruq)+tuq
huvaiqtuq	hu+(va)+iqtuq
anu	a+(nu)
in’ngutaq	(in’ng)+ut+aq
aullarnata	a+(ullarna)+ta
ihuaqhijaa	ihuaq+(hi)+jaa
ungahiktuq	(ungahik)+tuq
qilluq	(qilluq)
inuaqtaa	(inu)+aq+taa
tagiuq	(tagiuq)
ukaliq	(uka)+liq
puptat	(pupta)+t
akiittuqtaqtuq	a+(kiittuqt)+aq+tuq
angun	(ang)+un
aptuniqtujuq	a+(ptuniqt)+ujuq
amaut	a+(ma)+ut
agiaqtaa	(agi)+aq+taa
akirarijaa	(akira)+rijaa
unaguittuq	una+gu+(it)+tuq
ivalu	(ivalu)
kuhirniq	(kuhirni)+q
uilgahuk	(uilg)+a+huk
aupajangajuq	(aupajanga)+juq
hiitqumingajuq	(hiitqum)+ingajuq
uuktuut	(uuktu)+ut
aplaangajuq	a+(plaanga)+juq
qiiq	(qi)+iq
iqhijuq	(iqhi)+juq
hilahiut	(hilahi)+ut
ipikhaqtaa	ipik+h+(aq)+taa
kikturiaq	ki+(kturi)+aq
uutiqtittuq	(uutiqti)+t+tuq
utaqqijaa	(utaqqi)+jaa
nuliangiqtuq	nulia+(ng)+iqtuq
iqaluktuq	(iqaluk)+tuq
imaatun	(ima)+atun
qanuqtaivakpiuk	qa+(nuqtaivakpi)+uk
paurvik	p+(aur)+vik
qiliqtuq	(qi)+liq+tuq
apquhaaqtaa	(apquha)+aq+taa
puptati	(pupta)+ti
kanangnaq	ka+(nang)+naq
pukkuq	p+(ukku)+q
patauliuqtuq	(patau)+liuq+tuq
ipikhaun	ipik+h+(a)+un
patiktaa	p+(atik)+taa
hiqquqtijjun	(hiqquqtijj)+un
iqutujuq	(iqutu)+juq
patuk	(pat)+uk
qqaajuqtuq	(qqaajuq)+tuq
pigliqtuq	(pigliq)+tuq
qin’ngauti	(qin’nga)+uti
ukutitaq	(uku)+ti+taq
aqiarurliuqtuq	(aqiarur)+liuq+tuq
naviktaa	n+(a)+vik+taa
ilingajuq	(il)+ingajuq
qin’ngaun	(qin’nga)+un
hivulliq	(hivu)+lliq
quqtuqqak	qu+(qtu)+qqak
apurvikhaqhiuqtuq	(apurvi)+khaq+hiuq+tuq
aujaq	a+(uj)+aq
ujurukhaq	(ujuru)+khaq
havviqun	(havviq)+un
unipkaaq	(unipka)+aq
qipingajuq	qi+(p)+ingajuq
ikummat	(ikum)+ma+t
qurlurniq	(qurlur)+niq
kukuktuq	(kuk)+uk+tuq
aijuq	a+(i)+juq
taimailiuqtuq	ta+(imai)+liuq+tuq
qanuritpa	(qanurit)+pa
nukakhaq	(nuka)+khaq
naalauti	(naala)+uti
aupajaaqtuq	(aupaja)+aq+tuq
hingiq	(hing)+iq
imingajuq	(im)+ingajuq
algauti	(alga)+uti
havarluqutainnannguqtuq	(havarluqutainnann)+guq+tuq
ikualajuq	(ikuala)+juq
nikhiktaa	(nikhik)+taa
qanniqtuq	qa+(nn)+iqtuq
piksasuurvik	p+(iksasuur)+vik
niqikhaqtaa	niqi+(kh)+aq+taa
kakiniq	ka+(ki)+niq
aqiaruijaijuq	(aqiaruij)+aijuq
qin’ngun	(qin’ngu)+n
aphaqpallaijuq	(aphaqpall)+aijuq
kitautiqtuq	ki+(taut)+iqtuq
niaqqulrujuq	(niaqqulr)+ujuq
pilihaarnirmin	(pilihaarnir)+min
immittuq	(imm)+it+tuq
uqqariktuq	(uqqa)+rik+tuq
nipiliurun	(nipiliur)+un
alrujiqiji	(alrujiqi)+ji
qilirniiqtaa	qil+irni+(iq)+taa
nakuunngittuq	(nakuu)+nngit+tuq
akikitqijaujuq	a+(kikitqija)+ujuq
uqummiaqtaa	(uqummi)+aq+taa
havangtinnahi	havang+(tinna)+hi
piniraq	p+(inir)+aq
utimun	(utim)+un
hunauva	huna+(uva)
nunguqhuqtuq	(nunguq)+hu+qtuq
uvaguk	(uvag)+uk
ahiaqtaqtuq	a+(hiaq)+taqtuq
hiut	(hi)+ut
qukturaq	(quktur)+aq
tatilgaq	ta+(tilg)+aq
anaqtaun	(anaqta)+un
hiipangnittuq	hi+(ipangni)+t+tuq
ittuaqtuq	(ittu)+aq+tuq
akuliak	(akulia)+k
ajaraaq	a+(jara)+aq
ublaigami	(ublaiga)+mi
hiulluktuq	hi+(ul)+luk+tuq
ivjaqun	(ivjaq)+un
qarjuk	(qa)+rj+uk
angujakti	(angujak)+ti
alianai	(alianai)
nujuaqtujuq	n+(ujuaqtu)+juq
publaumajuq	publ+(auma)+juq
uluaraut	ulu+(ara)+ut
tikinnani	tikin+(nani)
qallut	(qall)+ut
tagjaaqtuq	(tagj)+aaq+tuq
aallannguqtuq	a+(allann)+guq+tuq
titirarvigijaa	t+(itirarvi)+gijaa
tahitirijuq	tahi+(tiri)+juq
ukharjuk	(ukha)+rj+uk
kitkuk	ki+(tk)+uk
kigutigikhaun	kigu+(tigikha)+un
uluaqtaa	ulu+(aq)+taa
qitiraq	qi+(tir)+aq
taimani	ta+(im)+ani
hiirnaqtuq	hi+(ir)+naq+tuq
qirnangajuq	qi+(rnanga)+juq
ilijaa	(ili)+jaa
apiqhuivik	(apiqhui)+vik
initujuq	(init)+ujuq
aqittuq	(aq)+it+tuq
hiutik	hi+(u)+tik
anguaqtuq	(angu)+aq+tuq
inuaqtuq	(inu)+aq+tuq
atukkat	(atu)+kkat
arnarvik	(arnar)+vik
atuun	(atu)+un
kumiktuq	(ku)+mik+tuq
qablunaaq	(qablu)+naaq
najjak	(najja)+k
kiliqtaa	ki+(liq)+taa
aippaq	a+(ipp)+aq
ipu	(ipu)
atuqtitaa	(atuqti)+taa
taavani	ta+(av)+ani
anguhuqtuq	(angu)+hu+qtuq
tiuqtiuqtuq	(tiuqtiuq)+tuq
piujaqtuq	(piuj)+aq+tuq
ilaruhirijaa	(ilaruhi)+rijaa
hiquqtaa	(hiq)+uq+taa
ublaaq	(ublaa)+q
kakkiviaq	ka+(kkivi)+aq
piksaliuti	(piksali)+uti
tuphijuq	(tup)+hi+juq
qitiqqautijuq	qi+(tiqqauti)+juq
ihummarluktuq	(ihu)+mmarluk+tuq
hangiaktuq	(hangi)+ak+tuq
hilaluktuq	(hila)+luk+tuq
allaruti	(allar)+uti
haluuqtuq	(haluuq)+tuq
niripkaqtaa	(niri)+pkaq+taa
uqhurjuaqtaun	(uqhurjuaqta)+un
inukhiarijaa	(inukhia)+rijaa
aulvik	a+(ul)+vik
anniruhuktuq	(anniru)+huk+tuq
kuutiruq	(kuuti)+ruq
atungaq	a+(tung)+aq
uaqhiti	(uaqhi)+ti
imunrit	(i)+mun+rit
imiqtaa	(imiqta)+a
tuhaajaa	(tuhaa)+jaa
ajuaq	(aju)+aq
havangnata	havang+(na)+ta
uvattiaguttauq	(uvattia)+gu+ttauq
arnaqhiun	(arna)+qhi+un
pualulik	(pualu)+lik
hungaq	hu+(ng)+aq
kangiqhijaa	kang+(iqhi)+jaa
havangtinnata	havang+(tinna)+ta
pukukkit	p+(uku)+kkit
ilaanilu	(ilaani)+lu
naunaqtuq	(nau)+naq+tuq
hivuniqhipkaqtaa	hivun+(iqhi)+pkaq+taa
kikiaktaa	(kikiak)+taa
titirakhaq	(titira)+khaq
angut	(ang)+ut
ikhiq	(ik)+hiq
iki	(iki)
ini	(i)+ni
pijumaffaaqtuq	(pijuma)+ffaaq+tuq
kangiqhijuq	kang+(iqhi)+juq
hiti	(hiti)
nirjut	(nirj)+ut
ihumajuq	(ihuma)+juq
tikinnanga	tikin+(na)+nga
hainngiguhuktuq	(hainngi)+gu+huk+tuq
qaptiruti	(qaptir)+uti
milvik	(mil)+vik
tuktu	(tuktu)
nuluq	(nul)+uq
tagjaaq	t+(agj)+aaq
iqalukpik	(iqaluk)+pik
avittaa	(avit)+taa
uvva	(uvva)
apittiuvik	(apittiu)+vik
higaaq	(higa)+aq
kikiaktuqtaa	(kikiak)+tuq+taa
qilaut	(qila)+ut
milukattak	(miluka)+ttak
angajukhiqun	(angajukhiq)+un
inukhuk	(inuk)+huk
kiguangirnaq	kigu+(angir)+naq
aglualiuqtuq	(aglua)+liuq+tuq
iqingajuq	(iq)+ingajuq
qiqittiivik	qi+(qittii)+vik
naimajuq	(naima)+juq
miniq	(mi)+niq
tarrijauti	(tarrija)+uti
inuilaq	(inuil)+aq
kikhuk	ki+(kh)+uk
kijjaktuq	(kijj)+ak+tuq
aluktuqtuq	(aluk)+tuq+tuq
ikkiti	(ikki)+ti
qaujuq	(qa)+ujuq
abluriq	(ablur)+iq
pijjarluktuq	(pijja)+rluk+tuq
angilraujuq	(angilrau)+juq
itqiq	(itq)+iq
uquutaq	(uqu)+ut+aq
pilihaarnirmi	(pilihaarnir)+mi
qanuritpin	(qanurit)+pin
ukpik	(ukpi)+k
aunaaqtuq	a+(una)+aq+tuq
aippirniq	a+(ippir)+niq
hiujjariktuq	(hiujja)+rik+tuq
arnaruhiq	(arnar)+uhiq
kivgaqtuqtuq	(kivgaq)+tuq+tuq
ikpakhaq	(ikpa)+khaq
publiun	publ+(i)+un
havilqhaq	havi+(lqh)+aq
iptiittuq	(ipti)+it+tuq
pujurvik	(pujur)+vik
qiqijuq	qi+(qi)+juq
uliktaa	(u)+lik+taa
tikitinnagik	(tikitinna)+gik
pilihaarnirmit	(pilihaarnir)+mit
piniqqak	(pini)+qqak
tikitinnatik	(tikitinna)+tik
aku	(aku)
kuvijaa	(kuvi)+jaa
annaktuq	(ann)+ak+tuq
nunguani	(nungu)+ani
ihumangnik	(ihuma)+ngnik
kakkiktuq	(ka)+kkik+tuq
uaqtuq	(u)+aq+tuq
immaqaak	(imma)+qaak
ulukhaqtuuq	ulu+(khaq)+tuuq
mikinnuarjuk	(mikinnua)+rj+uk
qamauktuqtuq	qa+(mauk)+tuq+tuq
aqiattuqtuq	a+(qiat)+tuq+tuq
ikuallautikhaq	(ikualla)+utikhaq
arnaqhiut	(arna)+qhi+ut
hiurjuk	hi+(urju)+k
ikhivautaq	(ikhiva)+ut+aq
nanguttijuq	(nangu)+ttijuq
akiani	(aki)+ani
tivjat	(tivja)+t
qinngarnaqtuq	qi+(nngar)+naq+tuq
ukiakhaq	(ukia)+khaq
uirniq	(uir)+niq
unipkaaqtuq	(unipka)+aq+tuq
amiakkut	(amia)+kkut
aullaqtinnagit	aullaq+(tinna)+git
ilutujuq	(ilutu)+juq
qamittuq	qa+(m)+it+tuq
ulurianaqtuq	(uluria)+naq+tuq
hivurallak	(hivura)+llak
ilulilik	(iluli)+lik
ajulaqtuq	a+(jul)+aq+tuq
minguliruqtuq	(minguli)+ruq+tuq
uligaaq	(uliga)+aq
quanaqqutit	(quanaqqu)+tit
uhiarut	(uhiar)+ut
aullaqtinnahi	aullaq+(tinna)+hi
humunngauvin	(hu)+munngau+vin
najak	(naja)+k
haki	(haki)
nungulaaq	(nungu)+laaq
kauttuarmiutarijaa	ka+(uttuarmiuta)+rijaa
takhiqtuq	ta+(kh)+iqtuq
uqaujaq	(uqauj)+aq
taimna	ta+(imna)
arnakhaq	(arna)+khaq
haumingmuuqtuq	(haumi)+ngmuuq+tuq
itiqtuq	(it)+iqtuq
mamarijaa	(mama)+rijaa
nipitairut	(nipitair)+ut
pilihaarniq	(pilihaar)+niq
uquittuq	(uqu)+it+tuq
nukaq	n+(uk)+aq
aullarnahi	a+(ullarna)+hi
igliaq	(igli)+aq
atan’ngujuq	a+(tan’nguj)+uq
qalaktuqtuq	(qalak)+tuq+tuq
kii	ki+(i)
hivulirijaa	hi+(vuli)+rijaa
ijaruvak	(ijaru)+vak
tallimiut	(talli)+miut
tumiruajuq	(tumirua)+juq
qipik	qi+(pi)+k
havangtinnagu	havang+(tinna)+gu
hukkinnaaq	hu+(kkin)+naaq
mikijuq	(miki)+juq
najuqtaa	(najuq)+taa
papiqqiqijuq	(papiqqiqi)+juq
qallutiqarvik	(qalluti)+qarvik
malruraaqtuq	(malru)+raaq+tuq
tuhaqtaa	(tuh)+aq+taa
uliun	(uli)+un
imiraq	(imir)+aq
uulijuq	(uuli)+juq
qalalaqijuq	(qala)+laqi+juq
qiku	qi+(ku)
aqhailitaq	(aqha)+ilitaq
qaphit	(qaphi)+t
akukittuq	a+(kuk)+it+tuq
halumailruq	(haluma)+ilruq
aiktaqtuq	a+(ik)+taqtuq
qulvik	qu+(lvi)+k
tiritquq	(tiritq)+uq
ihiqigaji	(ihiqiga)+ji
pata	(pata)
niqiliuqtuq	(niqi)+liuq+tuq
talittuq	(tal)+it+tuq
ittuq	(it)+tuq
ukujuq	(uku)+juq
aquun	(aqu)+un
pautik	(pau)+tik
punniq	p+(unn)+iq
imnaq	(imna)+q
iqaluqarvik	iqalu+(q)+arvik
hunngittuq	hu+(nng)+it+tuq
tunnuq	t+(unnu)+q
attiruaqtuq	a+(ttiru)+aq+tuq
ubluqtujuq	ubluq+(tu)+juq
nalujuq	(nalu)+juq
hinaaguuqtuq	(hinaa)+guuq+tuq
hiquriaqtaa	(hiquri)+aq+taa
taiguaqtaa	(taigu)+aq+taa
iqujuq	(iq)+ujuq
kautaujaq	ka+(utauj)+aq
aumait	(auma)+it
natirnaq	(natirn)+aq
iqqakuuqti	(iqqakuuq)+ti
im’ngun	(im’ng)+un
attiqtuijuq	(attiqtui)+juq
kihaqtuq	ki+(h)+aq+tuq
mitquq	(mitqu)+q
tiguaqtaa	(tigu)+aq+taa
ajaniqtujuq	(ajaniqt)+ujuq
anirniq	a+(nir)+niq
iquutikhauti	(iquutikha)+uti
tamuqtuq	(tamuq)+tuq
taliqpingni	(taliqpi)+ngni
qilaun	(qila)+un
minittailijaa	(minittaili)+jaa
taijuq	(t)+aijuq
kialaqijuq	(kia)+laqi+juq
aqaguani	(aqagu)+ani
qaniaq	(qani)+aq
hitamat	hi+(tama)+t
akhaluut	(akhalu)+ut
akikittuq	(aki)+kit+tuq
arvaaq	(arv)+aaq
aqiaruaqtuq	(aqiaru)+aq+tuq
ijjuaqtaa	(ijju)+aq+taa
aktikkutariik	(aktikkuta)+riik
imannaaqtuq	(imann)+aaq+tuq
ubluqhiuti	(ublu)+qhi+uti
ajuqtuq	a+(juq)+tuq
arja	(arja)
nakkaqtuq	(nakk)+aq+tuq
tupittuq	(tup)+it+tuq
havgun	(havg)+un
tuluriaq	(tulu)+riaq
inugiaktut	(inu)+giak+tut
ipikharniq	ipik+h+(ar)+niq
piannauhiq	(pianna)+uhiq
ainniq	a+(in)+niq
puvittuq	(puv)+it+tuq
qanilrukkut	qa+(nilru)+kkut
aullaqtuq	a+(ull)+aq+tuq
higaarluktuq	(higaa)+rluk+tuq
qaplu	(qaplu)
tiituqtuq	(tii)+tuq+tuq
aputaijaqtaa	(aputaij)+aq+taa
hanajuq	(hana)+juq
qaphinik	(qaphi)+nik
avatait	(avata)+it
hiuti	(hi)+uti
taimunga	ta+(imu)+nga
niurmiktuq	(niur)+mik+tuq
kinguani	(kingu)+ani
uqaallautijaa	(uqaallauti)+jaa
iniruajuq	(inirua)+juq
ahiruqtuq	(ahi)+ruq+tuq
navikhimajuq	navik+(hima)+juq
an’ngajuktuqtuq	a+(n’ngajuk)+tuq+tuq
anitaa	a+(ni)+taa
pigliqtaqtuq	(pigliq)+taqtuq
tukkaqtaa	(tukk)+aq+taa
aahanngiq	a+(ahanng)+iq
kakkiliqtaqtuq	ka+(kkiliqt)+aq+tuq
iqqanaiqtuq	(iqqana)+iqtuq
nipiliun	(nipili)+un
taitaiphaaqtuq	ta+(itaipha)+aq+tuq
algirnilaqijuq	(algirni)+laqi+juq
puiniq	(pui)+niq
aannuraangiqtuq	(aannuraang)+iqtuq
iluvirvik	(iluvir)+vik
havaqati	(hava)+qati
nuvihijuq	(nuvi)+hi+juq
paappak	p+(aappa)+k
qanurinngittuq	qa+(nuri)+nngit+tuq
akiraqatigiiktuk	(akira)+qatigi+iktuk
aluq	(alu)+q
qugjuk	(qugju)+k
ilihautijaa	(ilihauti)+jaa
tulaktuq	(tul)+ak+tuq
ulipkaaqtaa	(ulipka)+aq+taa
igluliqiji	iglu+(liqi)+ji
hinnariktuq	hi+(nna)+rik+tuq
nangutiqatigiiktuk	n+(anguti)+qatigi+iktuk
hulijakhaq	(hulija)+khaq
nalujaa	(nalu)+jaa
amauti	a+(ma)+uti
aluun	(alu)+un
nipikhaut	n+ipik+(ha)+ut
aqilluqqaq	a+(qilluq)+qaq
hangujuq	(hang)+ujuq
atuaqtaut	(atuaqta)+ut
uitapqaqtuq	(uitapq)+aq+tuq
atqaqtuq	(atq)+aq+tuq
qalaktuq	(qal)+ak+tuq
uqhurjualiqiji	(uqhurj)+ualiqiji
hurluk	(hu)+rluk
alguangajuq	(alguanga)+juq
havangnanuk	havang+(na)+nuk
nikhik	(nikhik)
qinmiq	qinmi+(q)
arjakuurvik	(arja)+kuurvik
aalliraq	a+(allir)+aq
aujuq	(a)+ujuq
piksasuuqtuq	p+(iksasuuq)+tuq
aqpattuq	(aqpa)+t+tuq
taktuktuq	(takt)+uk+tuq
avgun	(avg)+un
hangutitaqtuq	(hanguti)+taqtuq
kiguti	(kig)+uti
ihivjuktuq	(ihivj)+uk+tuq
nanuqtuq	(nanuq)+tuq
kangiqhuk	kang+(iq)+huk
ihivriuqhijuq	(ihivriuq)+hi+juq
hiujjarluktuq	(hiujja)+rluk+tuq
palvitujuq	(palvit)+ujuq
pualu	(pualu)
akhaktuq	a+(kh)+ak+tuq
anguuti	(angu)+uti
aptunikittuq	a+(ptuni)+kit+tuq
mitiinnaq	(miti)+innaq
quaqtaq	(qu)+aq+taq
havvarluktuq	(havva)+rluk+tuq
hikuaqtuq	(hiku)+aq+tuq
hivvuqtaa	hi+(vvuq)+taa
ilvit	(il)+vit
pimattiarniq	(pimattiar)+niq
tikinnanuk	tikin+(na)+nuk
aukhittiaqhimajuq	a+(ukhittiaqhima)+juq
nipiliut	(nipili)+ut
qilaujjaqtuq	(qilaujjaq)+tuq
ajaraaqtuq	a+(jara)+aq+tuq
inirnikhaq	(inirni)+khaq
illuktuq	(il)+luk+tuq
ingilraat	ingil+(ra)+at
kiguhiqijuq	kigu+(hiqi)+juq
talurjuaq	(talu)+rj+uaq
ihuuriktuq	(ihuu)+rik+tuq
aujijuq	(auji)+juq
humunngauliqqit	(hu)+munngau+liq+qit
qugluktuq	(qug)+luk+tuq
aalliak	a+(alli)+ak
avalliq	a+(va)+lliq
kaapi	ka+(api)
anaq	(a)+naq
qangiakhaq	qa+(ngia)+khaq
ivjujuq	(ivju)+juq
qilgiriaqtuq	(qilgi)+riaqtuq
uqautijaa	(uqauti)+jaa
aittiijuq	a+(ittii)+juq
ihumaalugijaa	(ihumaalu)+gijaa
higaarluk	(higaa)+rluk
makpiraq	(makpir)+aq
aktuqtaa	(ak)+tuq+taa
ihivriuqtuq	(ihivriuq)+tuq
tuuq	(tu)+uq
qanga	(qanga)
aputtaaq	(apu)+ttaaq
kikturiilitaq	ki+(kturi)+ilitaq
paipaut	(paipa)+ut
alianaqtuq	(alia)+naq+tuq
ikitaa	(iki)+taa
upluriaq	(uplu)+riaq
tunulliq	(tunu)+lliq
aqhaliaq	(aqhalia)+q
pujuq	(pu)+juq
taktuk	(takt)+uk
apijuq	(api)+juq
arvinilitaippaa	(arvini)+litaippaa
qilalugaaq	(qilalug)+aaq
mitiq	(miti)+q
hatqummiqtaa	(hatqummiq)+taa
tunuhitaq	(tunu)+hi+taq
nanijaa	(nani)+jaa
ilipiruq	(ilipi)+ruq
uqpiliurniq	(uqpiliur)+niq
majuraun	(majura)+un
malruk	(malru)+k
hii	hi+(i)
aquuti	(aqu)+uti
iqqakuurut	(iqqakuur)+ut
haumik	(haumi)+k
ukkuiqtuq	(ukku)+iqtuq
avguqtaa	(avg)+uq+taa
maliktaa	(ma)+lik+taa
ungullaun	(ungulla)+un
aaquaq	a+(aqu)+aq
hikun’ngiqtuq	hiku+(n’ng)+iqtuq
quanaqqutik	(quanaqqu)+tik
aturvik	(atur)+vik
takkuuk	(takku)+uk
humiutauvin	(humiutauv)+in
mittaqtuqtuq	(mittaq)+tuq+tuq
aukhiriaq	(aukhi)+riaq
atauttikkuuqtut	(atautti)+kkuuq+tut
iqquq	(iqq)+uq
mikinnuaq	(mikinnua)+q
maktaq	(makt)+aq
nujarluktuq	(nuja)+rluk+tuq
qanmaqtuq	qa+(nm)+aq+tuq
aquihimajuq	(aquihima)+juq
tuik	(tui)+k
imiqtaqtuq	(imiqt)+aq+tuq
havakti	havak+(ti)
katuut	ka+(tu)+ut
atqut	(atqu)+t
ihumakittuq	(ihuma)+kit+tuq
ailaqtuq	a+(il)+aq+tuq
uipkuaq	(uipku)+aq
imannaq	(imann)+aq
anaqtautiliqiji	(anaqta)+utiliqiji
mingulilaqijuq	(minguli)+laqi+juq
numiktiriji	numik+(tiri)+ji
nutaraq	(nutara)+q
auttuq	(aut)+tuq
ilaanittauq	(ilaani)+ttauq
ilingnik	(ili)+ngnik
tupiq	(tup)+iq
huna	(huna)
angmaniq	(angma)+niq
ingniqutilik	(ingniq)+uti+lik
kalliqtuq	(kall)+iqtuq
kigiaq	(ki)+gi+aq
kataktaa	ka+(tak)+taa
ungullauti	(ungulla)+uti
ahijjijuq	a+(hijji)+juq
qanaktaq	qa+(nak)+taq
imaiqtittuq	(imaiqt)+it+tuq
hilarluktuq	(hila)+rluk+tuq
imiqtaut	(imiqta)+ut
niuvirvik	(niuvir)+vik
ulik	(u)+lik
kuvjaqtuqtuq	(kuvjaq)+tuq+tuq
ihuma	(ihuma)
publaktuq	publ+(ak)+tuq
utiqtuq	(ut)+iqtuq
nujaittuq	(nuja)+it+tuq
putu	(putu)
atqunaqtuq	(atqu)+naq+tuq
ihuaqtuq	(ihu)+aq+tuq
polarbearcub	(polarbearcub)
qinngaqtuq	qi+(nng)+aq+tuq
akhaluun	(akhalu)+un
angujaktut	(angujak)+tut
tamaphi	(tamap)+hi
haqpik	(haq)+pik
piiqtaa	(pi)+iq+taa
pijariiqtaa	(pijari)+iq+taa
tuugaaq	(tuug)+aaq
anuqhaaqtuq	(anuqh)+aaq+tuq
katuuti	ka+(tu)+uti
alliaqtuqtuq	a+(lliaq)+tuq+tuq
pamiqhihuktuq	(pamiqhi)+huk+tuq
taki	ta+(ki)
agjautik	(agjau)+tik
avaalaqiaq	(avaalaqi)+aq
aanniaqtuq	a+(anni)+aq+tuq
qanuritpit	(qanurit)+pit
tariuliaqtuq	tariu+(li)+aq+tuq
pikuk	(pik)+uk
uummati	(uumma)+ti
hivuani	(hivu)+ani
kangiqhihurnaqtuq	kang+(iqhihur)+naq+tuq
ajjiqijuq	(ajjiqi)+juq
haulluut	(haullu)+ut
hiurjuut	hi+(urju)+ut
nigiq	(nig)+iq
ulapqiujaq	(ulapqiuj)+aq
amiraijaqtaa	(amiraij)+aq+taa
mirraq	(mirra)+q
nipin’ngajuq	(nipin’nga)+juq
nutaqqak	(nuta)+qqak
titiraakhaun	(titiraakha)+un
ikpan	(i)+kpan
qihik	qi+(hi)+k
mamaqtuq	(mamaq)+tuq
ippakhaq	(ippakha)+q
iijaa	(ii)+jaa
aunaaruiqtuq	a+(unaaru)+iqtuq
umiaqpak	(umiaq)+pak
attak	(atta)+k
qaqqulaaqtaa	(qaqqula)+aq+taa
iqaluktinnagu	iqaluk+(tinna)+gu
tunmirarijaa	(tunmira)+rijaa
atauttimuktait	(atauttimukta)+it
pirittaaqtuq	(piri)+ttaaq+tuq
atirluaqtuq	(atirlu)+aq+tuq
niaqurliuqtuq	(niaqur)+liuq+tuq
igunaq	(igu)+naq
imiraqtuun	(imiraqtu)+un
takuttailijuq	taku+(ttaili)+juq
akurut	(akur)+ut
kaapiliut	ka+(apili)+ut
ajagutaaq	(ajaguta)+aq
ipikhaijuq	ipik+h+(ai)+juq
hiqiniq	hiq+(i)+niq
auvvivik	(auvvi)+vik
uniaqtuq	(uni)+aq+tuq
hiku	(hiku)
nani	(nani)
agiaq	(a)+gi+aq
unnukpan	(unnu)+kpan
qilauti	(qila)+uti
tingmiakkuuqtuq	(tingmia)+kkuuq+tuq
niviuvak	(niviuva)+k
paamnguqtuq	paa+(mn)+guq+tuq
kivanmut	(kivanm)+ut
mamittuq	m+(ami)+t+tuq
angaajjuvik	a+(ngaajju)+vik
taitai	(taitai)
nipittaaqtuq	(nipi)+ttaaq+tuq
angiqpak	ang+(iq)+pak
atiqtuq	(at)+iqtuq
ikajuqtuq	(ikajuq)+tuq
unnuktuq	(unnuk)+tuq
amiraq	(amir)+aq
tigluuti	(tiglu)+uti
agliruq	a+(gli)+ruq
ukkuhik	(ukkuhi)+k
apqutiniktaa	apquti+(nik)+taa
qamnguinnaqtuq	qa+(mnguinn)+aq+tuq
apluriq	(aplur)+iq
manik	(ma)+nik
ihumagijauttiarniq	(ihumagijauttiar)+niq
niuviqtaa	(niuv)+iq+taa
tahittaaqtuq	(tahi)+ttaaq+tuq
uuktaun	(uukta)+un
ingnirvik	(ingnir)+vik
immiqtaa	(imm)+iq+taa
akulliquti	a+(kulliq)+uti
ilauti	(ila)+uti
igajuq	(iga)+juq
hananngaut	(hanannga)+ut
havangtinnagik	havang+(tinna)+gik
aarlungajuq	a+(arlunga)+juq
hiulliuqtuq	(hiul)+liuq+tuq
humiutauvit	(humiutauv)+it
humunngauliqqin	(hu)+munngau+li+qqin
qiniqtaa	qi+(n)+iq+taa
hatqummiqtuq	(hatqummiq)+tuq
taaqhijuq	(taaq)+hi+juq
akhaluuti	(akhalu)+uti
tikitinnagu	(tikitinna)+gu
angajugiik	(angaju)+giik
hiitquaq	(hiitqu)+aq
akiraq	(akiraq)
aumajuq	(auma)+juq
hituaqtuutit	hi+(tuaqtu)+ut+it
kipkaqtaa	(ki)+pkaq+taa
qihigalik	qi+(higa)+lik
upluqhiun	(uplu)+qhi+un
agjaqtuq	(agj)+aq+tuq
aliktaa	(a)+lik+taa
paan’nguqtuq	paa+(n’nguq)+tuq
avaliittuq	a+(vali)+it+tuq
haavraq	(haavr)+aq
qimirutit	qi+(mir)+ut+it
niaqun’ngujuq	(niaqun’ng)+ujuq
atuuti	a+(tu)+uti
qaqqulaannguqtuq	qa+(qqulaann)+guq+tuq
patqujaq	(patquj)+aq
iglu	(iglu)
pilraak	(pilra)+ak
aallami	(aalla)+mi
aliqakhaq	(aliqa)+khaq
kuniktuq	(kunik)+tuq
tikinnata	tikin+(na)+ta
piannaqatigijaa	piannaq+(ati)+gijaa
tigluktaa	(tigluk)+taa
amaun	a+(ma)+un
kiinaruq	(kiina)+ruq
uunnaalaqijuq	(uunnaa)+laqi+juq
niu	(niu)
taamnataamna	(taamnataam)+na
aput	(ap)+ut
kajumiktuq	ka+(ju)+mik+tuq
tulugaq	(tulu)+gaq
ppaamnguliaq	p+(paamnguli)+aq
angunahuaqti	angunahuaq+(ti)
qatiggaaqtuq	qa+(tigga)+aq+tuq
qitun’ngaq	qi+(tun’ng)+aq
haattuq	(haa)+t+tuq
aappakhaq	(aappa)+khaq
kakilahaaq	(kakilah)+aaq
titiqqittijuq	(titiqqi)+ttijuq
apirijaa	(api)+rijaa
tahiuqtaa	(tahi)+uq+taa
tailoffish	ta+(iloffish)
napuliut	(napuli)+ut
paun’raq	(paun’r)+aq
pigliriaq	p+(igli)+riaq
qaujimaittuq	qa+(ujima)+it+tuq
tikitinnahi	(tikitinna)+hi
hinnaktuqtuq	hi+(nnak)+tuq+tuq
hiquriaqtuq	(hiquri)+aq+tuq
haamirun	(haamir)+un
aluutinnuaq	(alu)+uti+nnuaq
aluaq	(alu)+aq
iliharvik	(iliharvi)+k
ilauqtuq	(ilauq)+tuq
ulujjat	(ulujja)+t
uvamnik	(uva)+mnik
higjariaq	(higja)+riaq
qin’nguti	(qin’ngu)+ti
ilaranaittuq	(ilarana)+it+tuq
annguti	(anng)+uti
maamakhaq	(maama)+khaq
uaqtaa	(u)+aq+taa
naammaktuq	(naamm)+ak+tuq
amaulik	a+(mau)+lik
aittuqtaa	(ait)+tuq+taa
angmaqtaa	ang+(m)+aq+taa
niujuq	(ni)+ujuq
kanajuq	ka+(na)+juq
atajuq	(ata)+juq
titiraakhaq	(titiraakha)+q
nunijuq	n+(uni)+juq
puvla	(puvla)
taanngaq	ta+(anng)+aq
upluqtujuq	(upluqt)+ujuq
qanilrukkun	qa+(nilru)+kkun
apiqhuqtuq	(apiq)+hu+qtuq
qakugu	(qakugu)
iqqakuuruti	(iqqakuur)+uti
mahuk	(mah)+uk
haqalikitaaq	(haqalikita)+aq
umingmak	umingma+(k)
kaivaluaqtuq	ka+(ivalu)+aq+tuq
qijuvik	qi+(ju)+vik
pamiuq	(pamiuq)
tatqiqhiun	(tatqi)+qhi+un
iluvrit	(iluv)+rit
nahaullik	(nahaullik)
attariktuq	(atta)+rik+tuq
nivaktaa	(nivak)+taa
uqamiluktuq	(uqami)+luk+tuq
nagjuk	n+(agj)+uk
hukattuq	hu+(kat)+tuq
angajukhaq	(angaju)+khaq
apquhiniq	(apquhi)+niq
piksaliun	(piksali)+un
tikitinnanga	(tikitinna)+nga
qaatiqtuq	qa+(at)+iqtuq
quahijaaqtuq	qu+(ahija)+aq+tuq
hivulliujuq	(hivulli)+ujuq
tupakhaqtaa	tupak+(h)+aq+taa
aarluk	a+(a)+rluk
kivjaqtaa	ki+(vj)+aq+taa
im’rut	(im’r)+ut
naunaitkuhiqtaa	(naunaitk)+uhiq+taa
uiniq	(ui)+niq
haniraq	(hanir)+aq
hiqquqtijjut	(hiqquqtijj)+ut
takpiktuq	(takpik)+tuq
uvinik	(uvi)+nik
qinngijuq	qi+(nngi)+juq
qikiqtaq	qikiqta+(q)
avin’ngaq	(avin’ng)+aq
akuttijuq	(aku)+ttijuq
nunguttuq	(nungu)+t+tuq
iqquk	(iqq)+uk
taliq	(tal)+iq
mittuq	(mi)+t+tuq
iqaluk	(iqaluk)
havangnahi	havang+(na)+hi
mikigaq	(miki)+gaq
hilaqqiqtuq	hila+(qq)+iqtuq
muqpaujaq	(muqpauj)+aq
iigijuq	(iigi)+juq
aippaagutqikpat	(aippaagu)+tqikpat
tuuqtuq	(tuuq)+tuq
hivvuqtuqtuq	hi+(vvuq)+tuq+tuq
nirihuiqtunga	(niri)+huiq+tunga
ipualik	(ipualik)
uingairnaqtuq	(uingair)+naq+tuq
malik	(ma)+lik
palvinaqtuq	(palvi)+naq+tuq
titiraqtuq	(titir)+aq+tuq
qanilrumi	qa+(nilru)+mi
aqpajuaqtuq	(aqpaju)+aq+tuq
majuqqaq	(majuqq)+aq
ivjaruti	(ivjar)+uti
qalviaq	(qalvi)+aq
hittuqittuq	hi+(ttuq)+it+tuq
quanaqquhi	(quanaqqu)+hi
pamiuqtuuq	(pamiuq)+tuuq
iqilgagiag	(iqilgagi)+ag
tagjuq	(tagj)+uq
nalariaq	(nala)+riaq
imiqtuq	(im)+iqtuq
ahinni	(ahinni)
haniani	(hani)+ani
qaniq	(qa)+niq
piqati	(pi)+qati
ilihimajara	ilihima+(jara)
ivjaruhiqtuqtaa	(ivjaruhiq)+tuq+taa
havangnatik	havang+(na)+tik
taiguqtuq	ta+(i)+guq+tuq
qanuqakituvaaa	qa+(nuqakituvaa)+a
akurun	(akur)+un
akimaittuq	(akima)+it+tuq
allaqtaa	(all)+aq+taa
unaaq	(una)+aq
ilaruhiq	(ilaruhi)+q
mitquiqtaa	(mitqu)+iq+taa
qijjaktuq	qi+(jj)+ak+tuq
aannuraaqarvik	(aannuraaq)+arvik
munngarman	(munngar)+man
aviktaa	(a)+vik+taa
tuhaajuq	(tuhaa)+juq
qarliik	qa+(rliik)
atukkiqtuq	a+(tukk)+iqtuq
iglautigijaa	(iglauti)+gijaa
crowberry	(crowberry)
maamauti	(maama)+uti
algaaq	(alga)+aq
iglaqtuq	(igl)+aq+tuq
ikkattuq	(ikka)+t+tuq
igliq	(igli)+q
nivinngarvik	(nivinng)+arvik
iqaluktuuttiaq	iqaluk+(tuu)+ttiaq
qakkuriktuq	qa+(kku)+rik+tuq
tunijaa	(tuni)+jaa
haamirut	(haamir)+ut
humik	(humi)+k
mikiliraq	(mikilir)+aq
apiqhuiji	(apiqhui)+ji
ataniq	a+(ta)+niq
ilumuuqtuq	(ilumuuq)+tuq
kingmiktaq	ki+(ngmikt)+aq
akiittuq	(aki)+it+tuq
apqun	(apqu)+n
nattiqtuq	(natt)+iqtuq
haamiruti	(haamir)+uti
hulijakhaqhiuqtuq	(hulija)+khaq+hiuq+tuq
hivumut	(hivum)+ut
aqhaktuq	(aqh)+ak+tuq
kuugarjuk	(kuuga)+rj+uk
patiq	(pati)+q
kanivaut	(kaniva)+ut
nippaqtuq	n+(ipp)+aq+tuq
kiujuq	(ki)+ujuq
hapun	(hap)+un
annirutijaujuq	(annirutija)+ujuq
uplumittauq	(uplu)+mi+ttauq
hanalrutit	(hanalr)+ut+it
aittuuhiaqtuq	a+(ittuuhi)+aq+tuq
takummarikhijaa	taku+(mmarikhi)+jaa
hivuaq	(hivu)+aq
pilaktuq	(pilak)+tuq
minilaqijuq	(mini)+laqi+juq
qiviaqtuq	(qivi)+aq+tuq
tugliqti	(tugliq)+ti
tuhujuq	(tuhu)+juq
hilarluk	(hila)+rluk
qiplarikhijuq	(qipla)+rik+hi+juq
iijjirurvia	(iijjirurvia)
uqajuittuq	(uqaju)+it+tuq
tikitinnatin	(tikitinna)+tin
mamaqhungnittuq	(mamaq)+hungnit+tuq
kiihijuq	ki+(ihi)+juq
qaffaktaqtuq	(qaffakt)+aq+tuq
akhaluutikkuuqtuq	akhaluuti+(kkuuq)+tuq
tikitqaaqtuq	t+(ikitq)+aaq+tuq
taaq	(ta)+aq
taimuuna	ta+(imuuna)
ilulliq	(ilu)+lliq
agluraqtuq	(aglur)+aq+tuq
tilarrin	(tilarr)+in
qaijuq	qa+(i)+juq
hani	(ha)+ni
aanaakhiiq	a+(anaakhi)+iq
uuktuuti	(uuktu)+uti
unaguqtaiqhajait	una+gu+(qtaiqhaja)+it
puhitaq	(pu)+hi+taq
miqhuqtitaq	(miqhuq)+ti+taq
hanmijuq	(hanmi)+juq
huunngittuq	hu+(u)+nngit+tuq
qigliriaqtuq	qi+(gli)+riaqtuq
mamiahuktuq	(mamia)+huk+tuq
quaqhalaarun	(quaqhalaar)+un
hilviaq	hi+(lvi)+aq
tatijaa	(tati)+jaa
qattaq	qa+(tt)+aq
ilupaaq	(ilupa)+aq
iliuqpik	(iliuq)+pik
irnituaq	(irni)+tuaq
qianngaqtuq	qi+(anng)+aq+tuq
ipiktuq	(ipik)+tuq
aiviqtuq	a+(iv)+iqtuq
tajarmiaq	ta+(jarmi)+aq
maamaun	(maama)+un
avittuk	a+(vitt)+uk
nakit	(nak)+it
nauktaimna	(nauktaim)+na
qaffit	qa+(ff)+it
hauniq	(hau)+niq
pimmarluktuq	(pi)+mmarluk+tuq
inukhijuq	(inuk)+hi+juq
iqiahuktuq	(iqia)+huk+tuq
umialik	(umia)+lik
inikhaqquqtujuq	(inikha)+qquqtu+juq
aqaguublaami	aqagu+(ublaa)+mi
iqhiqpak	(iqhiq)+pak
angijuq	a+(ngi)+juq
makpiraaq	(makpiraaq)
nurrakhaq	(nurra)+khaq
qiuktaqtuq	qi+(ukt)+aq+tuq
naqhaq	(naqh)+aq
takiunniin	ta+(kiunni)+in
auktiruti	(auktir)+uti
aqagumunngaqpat	aqagu+(munngaq)+pat
ilulliik	(ilu)+lliik
uluak	ulu+(ak)
kangiqhimaittuq	kang+(iqhima)+it+tuq
kikiak	(kikiak)
kihimi	ki+(hi)+mi
qungujuktuq	qu+(nguj)+uk+tuq
iilluut	(iillu)+ut
kapuuti	(kapu)+uti
tuuqtaa	(tuuq)+taa
ikkikhat	(ikkikha)+t
hanirarmiktuq	(hanirar)+mik+tuq
tupiqtuq	(tup)+iqtuq
aiq	a+(i)+q
aullarnani	a+(ullarna)+ni
hivuralik	(hivura)+lik
kakaktuq	ka+(k)+ak+tuq
aliktuqtaa	(alik)+tuq+taa
kumak	(kuma)+k
naunaipkuhiqtaa	(naunaipk)+uhiq+taa
inuhaaq	(inu)+haaq
pihiq	(pihi)+q
itibjaaq	(itibj)+aaq
naalaun	(naala)+un
kigutaiqtuq	kigu+(ta)+iqtuq
milukaqtuq	(miluk)+aq+tuq
nalvaaqtaa	n+(alva)+aq+taa
auktirun	(auktir)+un
higjaaq	(higja)+aq
haqiktauti	(haqikta)+uti
qulviliuqtuq	qu+(lvi)+liuq+tuq
hungajaaqtuq	hu+(ngaja)+aq+tuq
angilrauhiqtuq	(angilrau)+hiq+tuq
angajuk	(angaju)+k
apihimajuq	a+(pihima)+juq
anujaa	a+(nuja)+a
inuuhuktuq	(inuu)+huk+tuq
titiraun	(titira)+un
attirluaqtuq	a+(ttirlu)+aq+tuq
inuuqati	(inuuqati)
nirritit	(nirri)+tit
malriak	(malri)+ak
numiqtuq	(num)+iqtuq
arniqijuq	(arniqi)+juq
mahik	(ma)+hik
nangirvigijaa	(nangirvi)+gijaa
nutaaq	(nuta)+aq
qalingujuq	qa+(ling)+ujuq
ikpat	(ikpa)+t
qablunaavjak	(qablu)+naavjak
uik	(ui)+k
utimuktuqtuq	(utimuk)+tuq+tuq
aittuun	(aittu)+un
takujuq	ta+(ku)+juq
tulrujuq	(tulr)+ujuq
takimut	(takim)+ut
nalrujuq	(nalr)+ujuq
agiraqtuq	(agir)+aq+tuq
ajuiqhajaa	(ajuiqha)+jaa
sikiituuq	(sikii)+tuuq
nivjaaqtuq	(nivja)+aq+tuq
hiniktuq	hi+(nik)+tuq
tuqutaa	(tuqu)+taa
minguk	(minguk)
qannaqtujuq	qa+(nnaqtu)+juq
ipijuq	(ipi)+juq
kivviti	(kivvi)+ti
niliqtuq	(ni)+liq+tuq
ulujjak	(ulujja)+k
hurluktuq	(hu)+rluk+tuq
tukhungajuq	(tukhunga)+juq
aatituuqtuq	a+(ati)+tuuq+tuq
ijarluktuq	(ija)+rluk+tuq
ilannaq	(ilanna)+q
iqqakuuq	(iqqakuuq)
napaaqtuq	(napa)+aq+tuq
amaamak	a+(maamak)
ivjuhiliqtuq	(ivjuhil)+iqtuq
irmiut	(irmi)+ut
ujaraktujuq	(ujaraktu)+juq
uqaqatigijaa	(uqaqati)+gijaa
pukaraq	p+(ukar)+aq
ihivriuqtaa	(ihivriuq)+taa
tingmiaqtuq	(tingmi)+aq+tuq
hinigvik	hi+(ni)+g+vik
kablaq	ka+(bl)+aq
kujaktuq	(kuj)+ak+tuq
ikpati	(ikpa)+ti
ikkitautikhaq	(i)+kkita+utikhaq
kimik	ki+(mi)+k
tuqutqajaktuq	(tuqutqaj)+ak+tuq
iluviik	(iluvii)+k
ungirun	(ungir)+un
ingniquhiqiji	(ingniq)+uhiqiji
miqhuqtaa	(miqhuq)+taa
ipigaun	(ipiga)+un
tuurmiaq	(tuurmi)+aq
uplumi	(uplu)+mi
aittuqtuq	a+(it)+tuq+tuq
piqtuq	(p)+iqtuq
tigluut	(tiglu)+ut
niqi	(niqi)
palviittuq	(palvi)+it+tuq
tunguttuq	(tungu)+t+tuq
igluliuqti	(iglu)+liuq+ti
nipiliuti	(nipili)+uti
kiguhiqiji	(kig)+uhiqiji
imaittuq	(ima)+it+tuq
qunmut	(qunm)+ut
hunauvva	huna+(uvva)
angatkuq	ang+(atk)+uq
tablu	(ta)+blu
atungak	a+(tunga)+k
hiqulaaq	hiq+(ula)+aq
piaraq	(piar)+aq
tuattuq	(tua)+t+tuq
anaqtaut	(anaqta)+ut
un’nguq	(u)+n’nguq
aajuraq	a+(ajur)+aq
ih	(ih)
malruiqtuqtuq	(malru)+iqtuq+tuq
aniutaqtuq	a+(niu)+taqtuq
makanngittuq	(maka)+nngit+tuq
maniillat	(maniilla)+t
ailaq	a+(il)+aq
ikuhik	(iku)+hik
taqak	ta+(qa)+k
amaamaktuq	a+(maamak)+tuq
anmuujuq	a+(nmu)+ujuq
hivuliqtiliuqtuq	hi+(vuliqti)+liuq+tuq
kuvijuq	(kuvi)+juq
panituaq	(pani)+tuaq
kilgavik	ki+(lga)+vik
aqqaluaq	(aqqalua)+q
kuapikkat	(kuapi)+kkat
qitiqhiq	qi+(tiq)+hiq
immiqijuq	(immiqi)+juq
maniliqiji	(maniliqiji)
hatku	(ha)+tku
inuuqatigijaa	(inuuqati)+gijaa
kigutit	(kig)+ut+it
itimak	(itima)+k
titqauti	(titqa)+uti
takpiittuq	(takpi)+it+tuq
attatak	a+(ttata)+k
haulluqtuq	(haulluq)+tuq
titqaut	(titqa)+ut
aniqtak	(aniqta)+k
haglujuq	(haglu)+juq
uaqtiqtuq	(uaqt)+iqtuq
uqauhiq	(uqauhi)+q
tiirluk	(tii)+rluk
uqhuq	(uqhu)+q
utaqqiuqtaa	(utaqqi)+uq+taa
humin	hu+(mi)+n
qanirluktuq	(qani)+rluk+tuq
kinguniq	(kingu)+niq
mamaittuq	(mama)+it+tuq
natiruvik	(natiruvi)+k
annut	a+(nn)+ut
naarliuqtuq	(naar)+liuq+tuq
itkiq	(itk)+iq
unuqtuq	(unuq)+tuq
naniriaqturvik	(nani)+riaqtur+vik
kukiijaun	(kukiija)+un
taqtu	t+(aqtu)
ivgut	(ivg)+ut
nujait	(nuja)+it
aalliraujaq	a+(allirauj)+aq
mittarvik	(mitt)+arvik
anguniaqtuq	angun+(i)+aq+tuq
hamunngauliqtuq	(ha)+munngau+liq+tuq
kanajuraq	ka+(najur)+aq
qiqaujuq	qi+(qa)+ujuq
pijumatujuq	(pijumat)+ujuq
aannuraangijaqtuq	(aannuraang)+ijaqtuq
aalla	a+(alla)
tuqhuuk	(tuqhu)+uk
pauq	(pa)+uq
inuujuq	(inu)+ujuq
allarun	(allar)+un
iluittuq	(ilu)+it+tuq
uniaqti	(uni)+aq+ti
akilliq	(aki)+lliq
kappianaqtuq	(kappia)+naq+tuq
igjuk	(igju)+k
upin’ngakhaq	(upin’nga)+khaq
ingilraan	ingil+(raa)+n
iigluktuq	(iigluk)+tuq
kipataa	(kipa)+taa
taiguqtaa	ta+(ig)+uq+taa
agluqtuq	a+(gluq)+tuq
natquq	n+(atqu)+q
aputi	(ap)+uti
tunuttuq	(tunu)+t+tuq
puiguqtuq	(pui)+guq+tuq
kukik	(kukik)
inutquaq	(inutqu)+aq
kipattijuq	(kipa)+ttijuq
atuaqtaun	(atuaqta)+un
najakhaq	(naja)+khaq
puvviujaq	p+(uvviuja)+q
uqquuqut	(uqquuq)+ut
akikittuqtaarijaa	(akikittuqtaa)+rijaa
ilunngunaqtuq	(ilunngu)+naq+tuq
ikaaqtaa	(ika)+aq+taa
qingaq	(qing)+aq
aqpik	(aq)+pik
aittauqtuq	(aittauq)+tuq
aittaqtuq	(ait)+taqtuq
ikkikhati	(ikkikha)+ti
kinaatqin	ki+(naatq)+in
qaptirun	(qaptir)+un
piqpagijaa	(piqpa)+gijaa
qigliktaqtuq	(qiglik)+taqtuq
paut	(pa)+ut
qagaqtaun	(qaga)+qta+un
affaqpallaijuq	a+(ffaqpall)+aijuq
algiqhiijuq	(algiqhii)+juq
puvallaqtuq	p+(uvall)+aq+tuq
hunagaq	(huna)+gaq
tunu	(tunu)
ivjarut	(ivjar)+ut
pangaliktuq	pangalik+(tu)+q
pilaktaa	(pilak)+taa
aqumuktuq	a+(qum)+uk+tuq
inuittuq	(inu)+it+tuq
ingniqut	(ingniq)+ut
pualrin	(pualri)+n
ipiutaq	(ipi)+ut+aq
majurautaq	(majura)+ut+aq
finger	(finger)
aqhalialaqijuq	(aqhalia)+laqi+juq
ilaut	(ila)+ut
ingnak	(ingna)+k
nivaktuq	(nivak)+tuq
inugaq	(inu)+gaq
tamamnuk	(tama)+mnuk
ublumi	(ublu)+mi
utarujaq	(utaruj)+aq
aullaqtinnagik	aullaq+(tinna)+gik
tarjuliaqtuq	t+(arjuli)+aq+tuq
akulliq	a+(kulliq)
tivjarluktuq	(tivja)+rluk+tuq
nipiliuqtuq	(nipi)+liuq+tuq
kigaqtuq	(kig)+aq+tuq
ainnuaq	(ai)+nnuaq
kihajjariktuq	ki+(hajja)+rik+tuq
niujjijuq	(niujji)+juq
atiqujaanga	a+(tiqujaa)+nga
hingaijuq	(hing)+aijuq
allaqhijuq	(alla)+qhi+juq
mikkirun	(mikkir)+un
ungiruti	(ungir)+uti
nangmautaq	n+(angma)+ut+aq
auktuqtuq	a+(uk)+tuq+tuq
inuujaq	(inuuj)+aq
qanuq	qa+(n)+uq
hakhagiaq	(ha)+khagiaq
ikuallaktuq	(ikuall)+ak+tuq
paanruliaq	paa+(nruli)+aq
talukujaaq	ta+(lukuja)+aq
ippakhaani	(ippakha)+ani
nuviqhaaq	(nuviqh)+aaq
katimajut	(katimaj)+ut
tamaffi	ta+(ma)+ffi
hikuliaq	hi+(kuli)+aq
tajja	(tajja)
pingangnaq	(pingang)+naq
iqalliqijut	(iqalliqij)+ut
kataktuq	(kat)+ak+tuq
alilaaqtuq	(alila)+aq+tuq
alianaittuq	(alianai)+t+tuq
iviangik	(iviangi)+k
ukpirijaa	(ukpi)+rijaa
ivguti	(ivg)+uti
hiitquqtuq	hi+(itquq)+tuq
ilirahuktuq	(ilira)+huk+tuq
tipjariktuq	(tipja)+rik+tuq
qigliktuq	(qiglik)+tuq
patuqutaujuq	p+(atuquta)+ujuq
upin’ngaqhiqtuq	(upin’ngaqh)+iqtuq
qupilruq	(qupi)+lruq
qin’ngutik	(qin’ngu)+tik
naunaipkutaq	(naunaipk)+ut+aq
hinnakturni	hi+(nnaktu)+rni
imiruktuq	(imir)+uk+tuq
majurautit	(majura)+ut+it
quppirun	(quppir)+un
quanaqpiaqquhi	(quanaqpiaqqu)+hi
itqakhaijuq	(itqakh)+aijuq
ingmiqtuq	(ingm)+iqtuq
quaqhalaaruti	(quaqhalaar)+uti
kipkaqtuq	ki+(pk)+aq+tuq
hallaaqtuq	(hall)+aaq+tuq
uvattiagu	(uvattia)+gu
ahiruijuq	a+(hirui)+juq
ikittut	(ik)+it+tut
anmuktaa	(anmuk)+taa
ujaraliaq	(ujara)+liaq
hitammiut	(hitammi)+ut
innaqtuq	(in)+naq+tuq
pajaliqin	(paja)+li+qin
qiniqhiajaa	qi+(niqhia)+jaa
apiqhuijuq	(apiqhui)+juq
natirluit	n+(atirlu)+it
humiliqaak	(humi)+liqaak
tingmiaqhiuqtuq	(tingmiaq)+hiuq+tuq
mannik	(manni)+k
imiarjijuq	(imiarji)+juq
ilihimajuq	(ilihima)+juq
kahaktaa	ka+(hak)+taa
uaqtakhat	(uaqta)+khat
ipiqtuq	(ip)+iqtuq
killaijaqtaa	k+(illaij)+aq+taa
nukaun’nguq	nuka+(u)+n’nguq
akhaarniq	a+(khaar)+niq
tigliktaa	(tiglik)+taa
itqanaiqtuq	(itqana)+iqtuq
hurjuktuq	hu+(rj)+uk+tuq
tikinnatin	tikin+(na)+tin
pijumaphaaqtuq	(pijumapha)+aq+tuq
akhun	a+(kh)+un
timi	(ti)+mi
uaqhin	(uaqhi)+n
miriaqtuq	(mi)+riaqtuq
qallun	(qall)+un
kiahirutilik	(kiahir)+uti+lik
tuqulrajaqtuq	(tuqulraj)+aq+tuq
uqquaq	(uqqu)+aq
ikkin	(i)+kkin
aliqti	a+(liq)+ti
haavitaa	(haavi)+taa
iliptik	(ilip)+tik
iqqakuurun	(iqqakuur)+un
minguliqtuq	(mingul)+iqtuq
titiraq	(titir)+aq
itqiliq	(itqili)+q
kiattik	(kiat)+tik
tunuhiq	(tunu)+hiq
niuvvaajuq	(niuvvaa)+juq
ublaami	(ublaa)+mi
apquhiuqtuq	(apqu)+hiuq+tuq
pataliqin	(pata)+li+qin
aqhaaqtaujuq	(aqhaaqta)+ujuq
niujijuq	(niuji)+juq
inikhaqaqtuq	(inikhaq)+aq+tuq
ikuhingmiktaa	ikuh+ingmi+(k)+taa
kiviktaa	(ki)+vik+taa
ningahuktuq	(ninga)+huk+tuq
qangiaq	qa+(n)+gi+aq
qanilruq	(qani)+lruq
tivjaq	(tivja)+q
majuraqtuq	(majur)+aq+tuq
hivumun	(hivum)+un
qijuktaqtuq	qi+(juk)+taqtuq
angajuqqaaq	a+(ngajuqqa)+aq
nagluqitaqtuq	(nagluqit)+aq+tuq
umilik	(umi)+lik
amaruaq	a+(maru)+aq
tumi	(tu)+mi
pingangnaqtuq	(pingang)+naq+tuq
ivjaruhiqtaa	(ivjaruhiq)+taa
mamiahujuittuq	(mamiahuju)+it+tuq
kaaffi	ka+(a)+ffi
tuujjaarnaqtuq	(tuujjaar)+naq+tuq
angutikhaq	(anguti)+khaq
aullarnanuk	a+(ullarna)+nuk
uuktauti	(uukta)+uti
hiurjuuti	hi+(urju)+uti
alikhaq	a+(li)+khaq
pattaaqtaa	p+(atta)+aq+taa
aullaaqtuq	a+(ull)+aaq+tuq
kamiktuqtuq	ka+(mik)+tuq+tuq
apittuq	(ap)+it+tuq
hiqanaakhiuti	hiq+(anaakhi)+uti
aalliniq	a+(alli)+niq
tuutaujaq	(tuutauj)+aq
qauq	(qa)+uq
tuharnarnaqtuq	(tuharnarn)+aq+tuq
ukuaq	(uku)+aq
apurvik	(apurvi)+k
kingloon	ki+(ngloo)+n
paan’nguliaq	(paan’nguli)+aq
nutiplik	n+(utip)+lik
ariujaa	a+(riu)+jaa
qanittuq	(qani)+t+tuq
ingniqun	(ingniq)+un
paniqtuq	(paniq)+tuq
pualrihaqtaa	(pualrih)+aq+taa
humit	(humi)+t
inuarullik	(inuarullik)
kuvjiqtuq	(kuvj)+iqtuq
pitqujaa	(pitqu)+jaa
hannaiqtuq	(hanna)+iqtuq
tiggak	(tigga)+k
uqquujuq	(uqqu)+ujuq
itibjaaqtuq	(itibj)+aaq+tuq
taitaiffaaqtuq	(taitai)+ffaaq+tuq
tiggutik	(tiggu)+tik
nuvujalaqijuq	(nuvuja)+laqi+juq
titrauti	(titra)+uti
atungaujaq	a+(tungauj)+aq
qakipqajuq	qa+(kipqa)+juq
aluuti	(alu)+uti
tunuani	(tunu)+ani
hiquqtuq	hi+(quq)+tuq
ilaun	(ila)+un
amaamaut	a+(maama)+ut
qiniqtuq	qi+(n)+iqtuq
ujarak	(ujara)+k
nuqitaa	(nuqi)+taa
qin’raun	qi+(n’ra)+un
pijumajuq	(pijuma)+juq
hikuun	(hiku)+un
tunmirautit	(tunmira)+ut+it
qaplunaatun	(qaplu)+na+atun
akiliqtaa	(akil)+iq+taa
imiq	(imi)+q
papiruq	(papi)+ruq
ulimakkak	(ulimakkak)
piksaliuqtaa	(piksali)+uq+taa
hilamiittuq	hila+(mi)+it+tuq
immitqiktaa	(immitqik)+taa
mitquti	(mitq)+uti
hinmiutaq	hi+(n)+miutaq
ataiqtuq	(ata)+iqtuq
quriiqtaq	(quriiq)+taq
allaliqtuq	(alla)+liq+tuq
uqhurjuaptaut	(uqhurjua)+pta+ut
qujagijaa	(quja)+gijaa
auk	(a)+uk
maliriq	(malir)+iq
nuvuja	(nuvuja)
takimun	(takim)+un
uqumuujuq	(uqumu)+ujuq
ikkit	(ikki)+t
kiiliqtaa	ki+(il)+iq+taa
tipaattuq	(tipaa)+t+tuq
nalaumajuq	(nalauma)+juq
ahiaq	(ahi)+aq
allaijaqtaa	(allaij)+aq+taa
aulajjut	(aulajj)+ut
hanirarmik	(hanirar)+mik
iji	(i)+ji
ivitaaruq	(ivitaa)+ruq
malrijuq	(malri)+juq
apitilirvia	a+(pitil)+irvia
tahitaa	(tahi)+taa
iggiaq	(ig)+gi+aq
aullarnatin	a+(ullarna)+tin
pijuminaqtuq	(pijumi)+naq+tuq
hanimut	(hanim)+ut
upin’raaq	(upin’ra)+aq
anaqtuq	(a)+naq+tuq
halraqtuq	(halr)+aq+tuq
amigaittut	(amiga)+it+tut
atqin	(atq)+in
igluktuuqtuq	iglu+(k)+tuuq+tuq
ingittuq	(ing)+it+tuq
nipiliuruti	(nipiliur)+uti
pihuktuq	(pi)+huk+tuq
igitaa	(igi)+taa
aqiaruijaqtaa	(aqiaruij)+aq+taa
uvanga	(uva)+nga
havangnanga	havang+(na)+nga
tahiraq	tahir+(a)+q
pihujjarluktuq	(pihujja)+rluk+tuq
nalunaqtuq	(nalu)+naq+tuq
illaijut	(illaij)+ut
ungirut	(ungir)+ut
nunaliqun	(nuna)+liq+un
nirlirnaq	n+(irlirn)+aq
kiluaqtuq	ki+(lu)+aq+tuq
ilarahuktuq	(ilara)+huk+tuq
makpiraaqarvik	(makpiraaq)+arvik
aniu	a+(niu)
igjuuk	(igju)+uk
aaktuq	(a)+ak+tuq
qikaaqtuq	qi+(ka)+aq+tuq
uilgarniq	(uilgar)+niq
aannuraaqtuqtuq	(aannuraaq)+tuq+tuq
ihivjuraq	(ihivjur)+aq
ungirlaaq	(ungir)+laaq
hinikhaq	(hini)+khaq
imariktuq	(ima)+rik+tuq
kivgaluk	ki+(vgal)+uk
taaqtuq	(ta)+aq+tuq
hakugiktuq	(hakugik)+tuq
naviktuq	navik+(tu)+q
tupaaqtaa	(tupa)+aq+taa
ikuutaqtuq	(ikuut)+aq+tuq
imiqtauti	(imiqta)+uti
alraaq	a+(lra)+aq
uplukittuq	(uplu)+kit+tuq
patautuqtuq	(patau)+tuq+tuq
umngijaqtuq	(umng)+ijaqtuq
haumimni	(haumi)+mni
iqitaa	(iqi)+taa
kanivaun	(kaniva)+un
qauqtaq	qa+(uq)+taq
atuqtuujaq	(atuqtuuj)+aq
nuvuk	(nuv)+uk
hanahuillun	(hanahuillu)+n
kiliqtuq	(kil)+iqtuq
puja	(puja)
aluut	(alu)+ut
puiguqtaa	(puig)+uq+taa
qimuktuq	qi+(m)+uk+tuq
hikuarniq	hiku+(ar)+niq
avalu	a+(va)+lu
utuqqaq	(utuq)+qaq
nangiaqtuittuq	(nangiaqtu)+it+tuq
huukiaq	hu+(uki)+aq
hinaaqhijuq	(hinaa)+qhi+juq
qiajuq	qi+(a)+juq
apun	(ap)+un
qinmiarjuk	qinmi+(a)+rj+uk
aik	a+(i)+k
allarut	(allar)+ut
qutangajuq	(qutanga)+juq
agjaqtaa	(agj)+aq+taa
takunnaqtuq	taku+(nn)+aq+tuq
unnuk	(unnuk)
humiitpa	hu+(miitpa)
hiqiqtuq	(hiq)+iqtuq
kuapigaq	(kuapi)+gaq
hilataani	hila+(ta)+ani
naalaktuqnaalaktuq	(naalaktuqnaal)+ak+tuq
naulaq	(naul)+aq
algalaq	a+(lgal)+aq
puujjuk	p+(uujj)+uk
ivjaquti	(ivjaq)+uti
akhuuqtuq	a+(khuuq)+tuq
aallatqiiktuk	(aallatqiiktu)+k
hivajaaqtuq	hi+(vaja)+aq+tuq
nangmaktaq	(nangmakt)+aq
anuqhilaqiliqtuq	(anuqhilaqil)+iqtuq
aupajangattuq	(aupajanga)+t+tuq
tujurmiaq	(tujurmia)+q
himmauhiqtaa	(himma)+uhiq+taa
aikhiqtuq	(aikh)+iqtuq
quaq	(qu)+aq
nuijjiijuq	(nuijjii)+juq
nuniq	(nu)+niq
nipitiruti	(nipitir)+uti
tuulligaaq	(tuulliga)+aq
apittiujuq	(apittiu)+juq
hikuut	(hiku)+ut
kigutigikhauti	kigu+(tigikha)+uti
pulaliqtuq	(pula)+liq+tuq
uingaiqtuq	(uinga)+iqtuq
piissak	(piiss)+ak
tukaliktuq	(tukalik)+tuq
puviqhimajuq	puvi+(qhima)+juq
annuk	(ann)+uk
iluliittuq	(iluli)+it+tuq
ilitarijaa	(ilita)+rijaa
atigi	a+(tigi)
iqqaqtuq	(iqq)+aq+tuq
nuuttuq	(nuu)+t+tuq
tiiliuqtuq	(tii)+liuq+tuq
kaivjaqtaa	ka+(ivjaq)+taa
uplaigami	(uplaiga)+mi
quq	(q)+uq
aqhalingiaq	(aqhalingia)+q
pauqtuq	p+(auq)+tuq
ubluqhiut	(ublu)+qhi+ut
qugluktaa	(quglukta)+a
arnaaqutaq	(arnaaq)+ut+aq
abluqtuq	a+(bluq)+tuq
hain’riguhuktuq	(hain’ri)+gu+huk+tuq
mihuktuq	(mi)+huk+tuq
aqiaviniq	(aqiavi)+niq
pitquhiqtuqtuq	(pitquhiq)+tuq+tuq
ulrujuq	(ulr)+ujuq
tagiuqtuq	(tagiuq)+tuq
avittuq	a+(v)+it+tuq
ajanikittuq	a+(janik)+it+tuq
kiluuttaqtaq	(kiluutt)+aq+taq
iqitquq	(iqitq)+uq
kigutiliqiji	(kig)+utiliqiji
nakinpijat	(nakinpija)+t
uqquuquti	(uqquuq)+uti
havangtinnanuk	havang+(tinna)+nuk
attiqtaa	(att)+iq+taa
qalairaqtuq	(qalair)+aq+tuq
titirauhiq	(titira)+uhiq
ivjarun	(ivjar)+un
nappannguqtuq	(nappann)+guq+tuq
manniliuqtuq	(manni)+liuq+tuq
pakkaq	p+(akk)+aq
imaruqtuq	(ima)+ruq+tuq
kanguq	(kangu)+q
atqaujuq	a+(tqa)+ujuq
hukhamut	hu+(kham)+ut
muqpak	(muq)+pak
igalaaq	(iga)+laaq
nakiqtuq	(nak)+iqtuq
ugjullak	(ugju)+llak
taimaa	(taima)+a
angilraqtuq	(angilr)+aq+tuq
aallaunahugijaa	(aallaunahu)+gijaa
angulajuq	ang+(ula)+juq
kingulliq	(kingu)+lliq
tautuktuq	(taut)+uk+tuq
alurnaq	a+(lur)+naq
qaffinikukiuqaqqin	qaffinik+ukiuq+(a)+qqin
quvianaittuq	(quviana)+it+tuq
tammaqtuq	ta+(mm)+aq+tuq
hilaluk	(hila)+luk
makaqtaa	(makaq)+taa
aittuut	(aittu)+ut
imaq	(im)+aq
itqaqtuq	(itq)+aq+tuq
kaimalluriktuq	ka+(imallu)+rik+tuq
tungauttuq	(tungau)+t+tuq
umiarmi	(umiar)+mi
haqiktaun	(haqikta)+un
kannujaq	ka+(nnuj)+aq
kiguhiqqun	kigu+(hiqq)+un
tingmikhajuq	(tingmikha)+juq
haulluti	(haullu)+ti
ukuariik	(ukua)+riik
ataani	(ata)+ani
ivujuq	(iv)+ujuq
paniqhiqtuq	(paniq)+hiq+tuq
qakuguttauq	(qakugu)+ttauq
anautaq	(ana)+ut+aq
higaakhaq	(higaa)+khaq
hunamun	huna+(m)+un
uluaqtuqtaa	ulu+(aq)+tuq+taa
arnauniriik	(arnauni)+riik
atquti	(atq)+uti
kalluk	(kallu)+k
arlingnaqtuq	(arlingn)+aq+tuq
tukhuktaa	(tukhuk)+taa
tupikhaq	(tupi)+khaq
aannuraaq	(aannuraaq)
haqpingajuq	(haqp)+ingajuq
qaangiqtaa	qa+(ang)+iq+taa
apqutaittuq	(apquta)+it+tuq
hinaa	(hinaa)
tuktuujaq	tuktu+(uj)+aq
nanguqati	(nangu)+qati
atauhiinnaq	(atauhi)+innaq
qattarjuaq	(qattarju)+aq
kakkiijaut	(kakkiija)+ut
nipitqaqtuq	(nipitq)+aq+tuq
higguqquqtujuq	(higgu)+qquqtu+juq
ubluqtuhinia	ubluq+(tuhinia)
ihiq	(ihi)+q
qinmiqtuqtuq	qinmi+(q)+tuq+tuq
algu	(a)+lgu
ilu	(ilu)
nipaluk	(nipal)+uk
tinguk	(ting)+uk
ungullaut	(ungulla)+ut
nakuugilluanngitaa	(nakuu)+gi+llua+nngi+taa
kivvit	(kivvi)+t
uaqhivik	(uaqhi)+vik
uttuk	(utt)+uk
ilaranaqtuq	(ilara)+naq+tuq
alugvik	(alu)+g+vik
aittuuhiaq	a+(ittuuhi)+aq
paaqtaa	(paaq)+taa
naharaq	(nahar)+aq
kijjilaqijuq	k+(ijji)+laqi+juq
kiujaa	(kiu)+jaa
qaphaktaqtuq	qa+(phakt)+aq+tuq
qin’ngut	(qin’ngu)+t
uingaiqtaa	(uinga)+iq+taa
ungahitqiaq	(ungahitqi)+aq
puviqtaq	puvi+(qt)+aq
attit	(a)+ttit
pimmariktuq	p+(imma)+rik+tuq
qumaq	(qum)+aq
kingmitquq	ki+(ngmitq)+uq
putuguq	putu+(gu)+q
tuktuttuq	(tuktu)+t+tuq
ajurnarman	(ajurnar)+man
anaanattiaq	(anaana)+ttiaq
qitaujaq	(qitauja)+q
qablunaatun	(qablu)+na+atun
ningaqtut	(ningaqtu)+t
tingmiaqpak	(tingmiaq)+pak
kuummiujaaqtuq	(kuummiuja)+aq+tuq
qaqquqtuqtuq	qa+(qquq)+tuq+tuq
uriuqtuq	(uriuq)+tuq
amaamauti	a+(maama)+uti
aulajjun	(aulajj)+un
paun’ngaq	(paun’ng)+aq
pikhiktuq	(pik)+hik+tuq
uliktuq	(ulik)+tuq
ikpataujaq	(ikpatauj)+aq
ikpiguhuktuq	(ikpigu)+huk+tuq
ipiiqtuq	(ipi)+iqtuq
qajangnaqtuq	qa+(jang)+naq+tuq
uqaqtuq	(uq)+aq+tuq
ilakuit	(ilaku)+it
aqhaaqtaa	(aqha)+aq+taa
quviahunngittuq	(quviahu)+nngit+tuq
ingniq	(ingniq)
qattarjuk	(qattarju)+k
ai	a+(i)
iiqtuqtuq	(i)+iqtuq+tuq
ulapqijuq	(ulapqi)+juq
tariuliqtuqtaa	tariu+(liq)+tuq+taa
anaqtauti	(anaqta)+uti
ihuani	(ihu)+ani
piittuq	(pii)+t+tuq
taphi	ta+(p)+hi
arnautqiik	a+(rnautqii)+k
kapijuq	ka+(pi)+juq
tupagiaqtuq	tupag+(i)+aq+tuq
pinniittuq	(pinni)+it+tuq
kukukuulaq	(kukukuul)+aq
uqaq	(uq)+aq
havangtinnatik	havang+(tinna)+tik
mimiq	(mim)+iq
atuaqtauti	(atuaqta)+uti
ipirakhat	(ipira)+khat
angutituqtuq	(anguti)+tuq+tuq
uingajuq	(u)+ingajuq
nipitqaqtauti	(nipitqaqta)+uti
ikkikhan	(ikkikha)+n
tungullaktuq	(tungull)+ak+tuq
maqijuq	(maqi)+juq
pijumajaa	(pijuma)+jaa
nuitajuq	n+(uita)+juq
titiqqitaa	(titiqqi)+taa
havvariktuq	(havva)+rik+tuq
niriniaqtuq	(nirini)+aq+tuq
taluq	(talu)+q
mitquiqhijuq	(mitqui)+qhi+juq
mitquiqtuq	(mitqu)+iqtuq
unaguqtuq	(una)+guq+tuq
naluujaqtuq	(naluuj)+aq+tuq
natiruvilaqutijuq	(natiruvilaquti)+juq
aullaqtinnatin	aullaq+(tinna)+tin
titiqtuun	(titiqtu)+un
qituhuktuq	qi+(tu)+huk+tuq
igluaqtuq	(iglu)+aq+tuq
tuqhuaq	(tuqhu)+aq
qinmiriaktuq	qinmi+(ri)+ak+tuq
nutqangajuq	(nutqanga)+juq
igluittuq	(iglu)+it+tuq
mallaujuq	m+(alla)+ujuq
naluujauti	(naluuja)+uti
haniqpaijuq	(haniqp)+aijuq
ilukittuq	(ilu)+kit+tuq
tamuutijaa	ta+(muuti)+jaa
talva	(talva)
naalaut	(naala)+ut
annirutijaa	(annirutija)+a
ubluriaq)star	(ubluriaq)star)
unaguiqhivik	una+gu+(iqhi)+vik
kuvjaqhuqtuq	(kuvjaq)+hu+qtuq
pangnaarjuk	p+(angnaarju)+k
ukiijuq	(ukii)+juq
aqiamuk	(aqiam)+uk
hunamut	huna+(m)+ut
annivilittuq	(annivil)+it+tuq
nirumiktuq	(niru)+mik+tuq
ilainnunngaqtaa	(ilain)+nunngaq+taa
qilamiuqtuq	qi+(lamiuq)+tuq
titiraujaqtuq	(titirauj)+aq+tuq
alappaaqtuq	(alappa)+aq+tuq
pinnirijaa	(pinni)+rijaa
pualuliuqtuq	(pualu)+liuq+tuq
tarjuliqtuqtaa	ta+(rjuliq)+tuq+taa
ungataani	(ungata)+ani
taliqpik	(taliqpi)+k
iukkaqtuq	(iukk)+aq+tuq
kaavjiq	ka+(avj)+iq
hukhamun	hu+(kham)+un
hinikhaaqtuq	hi+(nikha)+aq+tuq
putukkuk	putu+(kk)+uk
kapihilik	(kapihi)+lik
qaaq	(qa)+aq
anurikittuq	anuri+(k)+it+tuq
umngijauti	(umngija)+uti
ilikkuurujuq	(ilikkuur)+ujuq
hivuliqti	hi+(vuliqti)
ivgit	(ivg)+it
inuaqtaujuq	(inuaqta)+ujuq
ihumaaluktuq	(ihumaa)+luk+tuq
qalutaujaq	qa+(lutauja)+q
uqarvigijaa	(uqarvi)+gijaa
agluaq	(aglu)+aq
mikhaanun	(mikha)+anun
iptiiqtuq	(ipti)+iqtuq
haput	(hap)+ut
qajaqtuqtuq	qa+(jaq)+tuq+tuq
utaqqijuq	(utaqqi)+juq
malliqtuq	(mall)+iqtuq
ihaqquk	(ihaqq)+uk
hiun	(hi)+un
attirniq	att+irni+(q)
ikumaniq	(ikuma)+niq
halumaittuq	(haluma)+it+tuq
aluktuq	(a)+luk+tuq
ihuuq	(ihu)+uq
qaqquq	qa+(qquq)
qulliujaq	qu+(lliuj)+aq
atugaq	(atu)+gaq
uningajuq	(un)+ingajuq
kuhiqtuq	(ku)+hiq+tuq
uplaaq	(uplaa)+q
arvak	(ar)+vak
illiqpik	(illiq)+pik
papik	(papi)+k
qaffinikukiuqaqqa	qaffinik+ukiuq+(aqqa)
aujijaqtuqtuq	a+(ujijaq)+tuq+tuq
kijjak	(kijj)+ak
naammajjavutik	(naammajjavu)+tik
hilahiun	(hilahi)+un
qaptirut	(qaptir)+ut
qilamik	(qila)+mik
aulajjuti	(aulajj)+uti
tiriganniaq	(tiriganni)+aq
ikuhingmingaaqtuq	ikuh+ingmi+(nga)+aq+tuq
iglaqtittijuq	(iglaqti)+ttijuq
aanniarvik	a+(anni)+arvik
qaqhauq	(qaqha)+uq
nivinngaqtaa	(nivinng)+aq+taa
titiraqti	(titir)+aq+ti
nulluk	n+(ull)+uk
akunniq	(akun)+niq
hiitquq	(hiitqu)+q
ungahiaqtuq	(ungahi)+aq+tuq
havangtinnagit	havang+(tinna)+git
nangmaktuq	(nangmakt)+uq
hikutirvia	hiku+(tirvia)
tamatkiqtaa	(tamatk)+iq+taa
qurluq	(qurluq)
ungahikkutigiiktut	(ungahik)+kuti+giik+tut
auktuqtaaqtuq	(auktuqt)+aaq+tuq
huiqtuq	(hu)+iqtuq
amiraijaijuq	(amiraij)+aijuq
iglupiaqtuqtuq	iglu+(piaq)+tuq+tuq
kinamik	ki+(na)+mik
hakiak	(haki)+ak
uqhurjuaqarvik	(uqhurjua)+qarvik
qivjaq	(qivj)+aq
kia	(kia)
kihimngiuqtuq	ki+(himngiuq)+tuq
qaniaqtuq	(qani)+aq+tuq
tuhunnaq	(tuhu)+nnaq
utkuhik	(utkuhi)+k
pituutaq	(pitu)+ut+aq
ungalaqtuq	(ungal)+aq+tuq
tikinnatik	tikin+(na)+tik
tarjukkuuqtuq	(tarju)+kkuuq+tuq
imaaqtuq	(ima)+aq+tuq
taqturuti	ta+(qtur)+uti
akujuq	a+(k)+ujuq
illaijuti	(illaij)+uti
uqqarikhijuq	(uqqa)+rik+hi+juq
ipiraq	(ipira)+q
uhuk	(uh)+uk
imunik	(imu)+nik
aliahuktuq	(alia)+huk+tuq
nuviqhaqtuq	(nuviqh)+aq+tuq
ubluq	(ublu)+q
qunguhiniq	(qunguhi)+niq
panikhaq	(pani)+khaq
mipku	(mi)+pku
ajjigiiktuk	(ajjigiiktu)+k
kingmautik	ki+(ngmau)+tik
pukkuliqhit	p+(ukkuliqh)+it
ininiktaa	(ininik)+taa
anijuq	a+(ni)+juq
ilihimanngittuq	(ilihima)+nngit+tuq
nirijaa	(niri)+jaa
pinguatigaq	(pinguatig)+aq
naglingnaqtuq	(nagling)+naq+tuq
ublumittauq	(ublu)+mi+ttauq
amiiqtuq	(ami)+iqtuq
huuq	(hu)+uq
iiqtaa	(i)+iq+taa
itkalruq	(itka)+lruq
nakahuk	(nak)+a+huk
iihijuq	(ii)+hi+juq
quviahugvik	(quviahu)+g+vik
tingmiaq	(tingmiaq)
tatattuq	(tata)+t+tuq
tuphiuqtuq	(tup)+hiuq+tuq
aqupliqtuq	(aqupl)+iqtuq
kuniktaa	(kunik)+taa
pangniq	(pang)+niq
ikijaa	(iki)+jaa
tulagvik	(tula)+g+vik
paan’ruliaq	paa+(n’ruli)+aq
akihaqtuq	(aki)+haq+tuq
iiluktuq	(ii)+luk+tuq
iluvruaq	(iluvru)+aq
kipijuq	ki+(pi)+juq
angiptak	ang+(ipta)+k
hanajaa	(hana)+jaa
ningauk	(ninga)+uk
qupanuaqpaarjuk	qu+(panuaqpaa)+rj+uk
umiktuq	(u)+mik+tuq
kitittijuq	ki+(ti)+ttijuq
uunaqtuq	(uu)+naq+tuq
kattuaq	(kat)+tuaq
aippaangani	(aippaang)+ani
uaqhit	(uaqhi)+t
piqhiqtuq	p+(iqhiq)+tuq
hunat	(huna)+t
hivajaut	hi+(vaja)+ut
nauna	(nau)+na
tagjuqtuq	(tagjuq)+tuq
ikijjuk	(ikijj)+uk
takunnaittuq	taku+(nna)+it+tuq
pamirraaqtuq	p+(amir)+raaq+tuq
tahittuq	(tahi)+t+tuq
ipulvik	(ipul)+vik
qitiq	(qit)+iq
tatqiqhiuti	(tatqi)+qhi+uti
piqalujaq	(piqaluj)+aq
uluaqtuun	ulu+(aqtu)+un
paja	(paja)
akimajuktuq	akima+(juk)+tuq
ikittaaqtuq	(ikitta)+aq+tuq
atuut	a+(tu)+ut
aqiaruq	(aqiaru)+q
alguilitaq	(algu)+ilitaq
ablaangajuq	(ablaanga)+juq
iijjilaqijuq	(iijji)+laqi+juq
uuktuun	(uuktu)+un
havangtinnatin	havang+(tinna)+tin
in’rutaq	(in’r)+ut+aq
umiaq	(umi)+aq
ikpakhaani	ikpakha+(a)+ni
kigutaijaqtaa	kigu+(taij)+aq+taa
uhiarun	(uhiar)+un
uhiqtiqtuq	(uhiqt)+iqtuq
ulu	(ulu)
taingna	ta+(ingna)
upluliuqtuq	(uplu)+liuq+tuq
akutuq	(aku)+tuq
immiuqtuq	(immiuq)+tuq
qipijaa	qi+(pi)+jaa
kaivittuq	ka+(iv)+it+tuq
katilvik	ka+(til)+vik
tigluun	(tiglu)+un
ikipkaqtaa	(iki)+pkaq+taa
nutaqqiuqtaa	nutaqq+(i)+uq+taa
piringajuq	p+(ir)+ingajuq
akulliqut	a+(kulliq)+ut
qaqhuk	qa+(qh)+uk
malrik	(malri)+k
kipkariktuq	(kipka)+rik+tuq
pitquhiq	(pitquhiq)
ugjugaq	(ugju)+gaq
kaaphi	ka+(ap)+hi
navvaq	(navv)+aq
marluk	(ma)+rluk
attik	(at)+tik
kivgaq	(kivgaq)
maamak	(maamak)
angitigijuq	ang+(itigi)+juq
aqamaaktuq	a+(qama)+ak+tuq
nutaqqijaa	nutaqq+(i)+jaa
uplu	(uplu)
aqilgiq	a+(qilgiq)
algaujaq	(algauj)+aq
akimahuqtuq	(akima)+hu+qtuq
tukkaliqtuq	(tukka)+liq+tuq
annuktuq	(ann)+uk+tuq
itipjaaq	(itipja)+aq
pingahuiqtuqtuq	(pingahu)+iqtuq+tuq
qanikturiiktuk	qa+(nikturiiktu)+k
mihiktuq	(mi)+hik+tuq
havikhavikhaq	havik+havik+(h)+aq
kamiijaqtuq	ka+(mi)+ijaqtuq
hakugiittuq	(hakugi)+it+tuq
qamnguqtuq	qa+(mn)+guq+tuq
takkurni	(takku)+rni
aqublingajuq	a+(qubl)+ingajuq
ihivriuqhiji	(ihivriuq)+hi+ji
paijuq	(pai)+juq
naliak	nali+(a)+k
ukkuaq	(ukku)+aq
hanaji	(hana)+ji
ajapqumiarvik	a+(japqumi)+arvik
ahu	a+(hu)
kuvjaq	(kuvj)+aq
kajangnaqtuq	ka+(jang)+naq+tuq
malrunnguqtait	malru+(nnguqta)+it
tukhiqtuq	(tukh)+iqtuq
nuutaa	(nuu)+taa
ininikhijuq	(ininik)+hi+juq
piffi	(pi)+ffi
nangiaqtuq	(nangiaqtu)+q
majuaqtuq	(maju)+aq+tuq
havikhaq	havi+(kh)+aq
auktuqtaqtuq	(auktuqt)+aq+tuq
hilahiuti	(hilahi)+uti
niviqtuq	n+(iv)+iqtuq
ivjurnauti	(ivjurna)+uti
amaamaun	a+(maama)+un
anguun	(angu)+un
aqhalingialaqijuq	(aqhalingia)+laqi+juq
aqiarurliqtuq	(aqiarur)+liq+tuq
upin’rakhaq	(upin’ra)+khaq
ungahikhijuq	(ungahik)+hi+juq
ikittuq	(i)+kit+tuq
makittuq	(ma)+kit+tuq
hunamiaqtuq	huna+(mi)+aq+tuq
kanivauti	(kaniva)+uti
kapihik	(kapihi)+k
ihajuq	(iha)+juq
iquutikhaun	(iquutikha)+un
hukatirut	hu+(katir)+ut
ubluqhiun	(ublu)+qhi+un
qilalugaqtuq	(qilalug)+aq+tuq
immiugaq	(immiu)+gaq
itigak	(itig)+ak
ikuutautit	(ikuuta)+ut+it
imaiqtuq	(ima)+iqtuq
qunmun	(qunm)+un
qutuk	qu+(tu)+k
hiurjuun	hi+(urju)+un
taloyoak	(taloyo)+ak
ulipkaaqtuq	(ulipka)+aq+tuq
ihumaliuqtuq	(ihuma)+liuq+tuq
pittaq	(pit)+taq
iqiahuujuq	(iqiahu)+ujuq
auviuqtuq	(auviuq)+tuq
amihut	a+(mih)+ut
uhiqtuq	(uhiqt)+uq
uliuhiniq	(uliuhi)+niq
ubluriaq	(ublu)+riaq
aullaaqhimajuq	aulla+(aqhima)+juq
nirijuq	(niri)+juq
hiluraqtuq	hi+(lur)+aq+tuq
aanniqtuq	a+(ann)+iqtuq
kuhiqtaqtuq	k+(uhiqt)+aq+tuq
niqait	(niqa)+it
aittuqtuijuq	(aittuqtui)+juq
ivgun	(ivg)+un
kapuut	(kapu)+ut
qilirniqtaa	qil+irni+(q)+taa
ukpatik	(ukpa)+tik
taktaa	ta+(k)+taa
nirjuti	(nirj)+uti
irmiuti	(irmi)+uti
higaaqtuq	(higa)+aq+tuq
upin’ngaaq	(upin’nga)+aq
nukatugaq	nuka+(tu)+gaq
tuffijuq	(tuffi)+juq
upluq	(uplu)+q
hiqquqtiun	(hiqquqti)+un
itijuq	(iti)+juq
quviagijaa	(quvia)+gijaa
quviahuktuq	(quvia)+huk+tuq
nuqhutik	n+(uqhu)+tik
uilik	(uili)+k
ubluirvia	(ublu)+irvia
aqpahijuq	(aqpa)+hi+juq
aqpaliutijuq	(aqpaliuti)+juq
katuktuq	(kat)+uk+tuq
hanningajulik	(hanningaju)+lik
kapihijuq	(kapihi)+juq
kivvin	(kivvi)+n
titiqqat	(titiqqa)+t
arjakhaq	(arja)+khaq
kalluguqtuq	(kallu)+guq+tuq
uummat	(uumma)+t
pamiqhaaq	p+(amiqh)+aaq
tivjaqtaqtuq	t+(ivjaq)+taqtuq
anikhaq	a+(ni)+khaq
tahiq	(tahi)+q
aaq	(a)+aq
ikajuqtaa	(ikajuq)+taa
nauliktaa	(nau)+lik+taa
haavittuq	(haavi)+t+tuq
qituhungnaqtuq	qi+(tuhung)+naq+tuq
akhunaaq	akhunaa+(q)
qajagijuq	qa+(jagi)+juq
havguti	(havg)+uti
takkumni	(takku)+mni
anguhalluq	ang+(uhalluq)
anguut	(angu)+ut
hiqanaakhiun	hiq+(anaakhi)+un
imaa	(ima)+a
qalvik	(qal)+vik
arviqtuq	(arv)+iqtuq
nujaq	(nuja)+q
ivjaqut	(ivjaq)+ut
qaritaq	(qarit)+aq
aqtuliqtuq	(aqtu)+liq+tuq
hulivit	(huli)+vit
hilami	(hila)+mi
ihuuqiq	(ihuuq)+iq
kuvjin	(kuvj)+in
ihuittuq	(ihu)+it+tuq
anguti	(angu)+ti
hiuraq	hi+(ur)+aq
juus	(juus)
haunittiaq	(haunittia)+q
tangmaaqtuq	t+(angma)+aq+tuq
qaangani	qa+(ang)+ani
takkarjuaq	ta+(kka)+rj+uaq
ikitaqtuq	(iki)+taqtuq
anngun	(anng)+un
kinguq	(kingu)+q
uhingajuq	(uh)+ingajuq
ui	(ui)
arnaqhiuti	(arna)+qhi+uti
nurraittuarjuk	(nurraittua)+rj+uk
kan’nguhuktuq	ka+(n’ngu)+huk+tuq
una	(una)
qipikhimajuq	(qipikhima)+juq
qaqautaq	qa+(qa)+ut+aq
kulavak	(kula)+vak
tingmijuq	(tingmi)+juq
aquttuq	(aqu)+t+tuq
nuvijaa	(nuvi)+jaa
illaijun	(illaij)+un
nullauhiqtuq	n+(ullau)+hiq+tuq
hiqqaqtuq	(hiqq)+aq+tuq
paamnguliaq	(paamnguli)+aq
avataaqtaqtut	(avataaq)+taq+tut
natiq	(nati)+q
haviqquujaq	havi+(qquuj)+aq
arnaqati	(arna)+qati
uuktaut	(uukta)+ut
ilihimmariktuq	(ilihimma)+rik+tuq
aqagumunngaqpan	aqagu+(munngaq)+pan
illaktut	(i)+llak+tut
titiqqiqhijuq	(titiqqi)+qhi+juq
minihitaq	(mini)+hi+taq
kapuraut	(kapura)+ut
hamani	(ham)+ani
niuviqtuq	(niuv)+iqtuq
itipjaaqtuq	(itipja)+aq+tuq
aallatuqtuq	(aalla)+tuq+tuq
tingittuq	(ting)+it+tuq
ihunngaq	(ihunng)+aq
tuullik	(tuul)+lik
upaktaa	(upak)+taa
iqalukhiun	iqaluk+(hi)+un
qalurautic	(qalura)+uti+c
puvipqurnaqtuq	puvi+(pqurn)+aq+tuq
uluaraqtuq	ulu+(ar)+aq+tuq
iliarjuk	(ilia)+rj+uk
iliranaittuq	(ilirana)+it+tuq
taliruq	ta+(li)+ruq
niuqhijuq	(niu)+qhi+juq
manniit	(manni)+it
killaijaijuq	k+(illaij)+aijuq
ajurnaqtuq	(ajur)+naq+tuq
atiruaqtuq	a+(tiru)+aq+tuq
hikun’riqtuq	hiku+(n’r)+iqtuq
algak	(alga)+k
algaijaqtuq	(alga)+ijaqtuq
kapuun	(kapu)+un
pauttuq	(pau)+t+tuq
aluktuqtaa	(aluk)+tuq+taa
hiqiniqpulaliqtuq	(hiqiniqpula)+liq+tuq
akiti	(aki)+ti
nakujuq	(nak)+ujuq
nukatukkaaq	nuka+(tukka)+aq
kiglukkuuqtuq	k+(iglu)+kkuuq+tuq
tupilak	(tupila)+k
tuhutujuq	(tuhutu)+juq
uunnaaqtuq	(uunna)+aq+tuq
ilihaijaa	(ilihai)+jaa
kiinaq	ki+(i)+naq
tunin’nguiqtirijuq	(tunin’nguiqtiri)+juq
kuhirnirit	(kuhirni)+rit
aqagumunngaqqqan	aqagu+(munngaq)+qqan
ahiani	(ahi)+ani
hiqanaakhiut	hiq+(anaakhi)+ut
irmiun	(irmi)+un
uvattiannuaq	(uvattia)+nnuaq
hatqummiqhijuq	(hatqummiq)+hi+juq
illulik	(illu)+lik
nipi	(nipi)
alvat	(alva)+t
puuvjaaqtuq	(puuvja)+aq+tuq
taqturut	ta+(qtur)+ut
naqittuq	n+(aq)+it+tuq
algaut	(alga)+ut
imiaqtuq	(imi)+aq+tuq
ingutaaqtuq	(inguta)+aq+tuq
piannaq	(pianna)+q
aliiquhiqtuq	a+(liiqu)+hiq+tuq
kaipiktijjutijuk	ka+(ipiktijjutij)+uk
ulingajuq	(ul)+ingajuq
hingirniq	(hingir)+niq
ingiuqtuq	(ingiuq)+tuq
pitquijuq	(pitqui)+juq
tamaptik	(tamap)+tik
ukkuaqtuq	(ukku)+aq+tuq
ikijuq	(iki)+juq
tipjarluktuq	(tipja)+rluk+tuq
qajjat	(qajja)+t
pualrit	(pualri)+t
akirariik	(akira)+riik
hanmitijuk	(hanmitij)+uk
uvattiaq	(uvattia)+q
inirniq	(inir)+niq
pingujaa	(pingu)+jaa
miqhuqtuq	(miqhuq)+tuq
algaiqhijuq	(algai)+qhi+juq
nakin	(nak)+in
qilak	(qila)+k
pualrihaqtuq	(pualrih)+aq+tuq
qilaqqaun	(qilaqqa)+un
apuqtuq	a+(puq)+tuq
qimugjuk	qi+(mugj)+uk
ilakuq	(ilaku)+q
qujajuittuq	qu+(jaju)+it+tuq
ikhivajuq	(ikhiva)+juq
akiliuhiarijaa	a+(kiliuhiarijaa)
hanaqijuq	(hanaqi)+juq
nakuuginngitaa	(nakuu)+gi+nngi+taa
hukatiruti	hu+(katir)+uti
hain’rihuktuq	(hain’ri)+huk+tuq
ungalliq	(unga)+lliq
naujaq	(nauj)+aq
akuliarikhijuq	(akulia)+rik+hi+juq
tupiqtuqtuq	(tup)+iqtuq+tuq
nulaq	(nul)+aq
pukkuk	p+(ukku)+k
qilluqiqtuq	(qilluq)+iqtuq
ilihaqtuq	(ilihaq)+tuq
katuun	ka+(tu)+un
anuri	a+(nuri)
kuttuq	(ku)+t+tuq
aullaqhimakhaaqtuq	aullaq+(himakh)+aaq+tuq
inuinnaqtun	(inu)+innaq+tun
hituaqtuq	(hitu)+aq+tuq
hituliqtuq	hi+(tu)+liq+tuq
publakhiijuq	publ+(akhii)+juq
sikuurvik	(si)+kuurvik
tarrijaun	(tarrija)+un
ilihaijuq	(ilihai)+juq
ikumajuq	(ikuma)+juq
tuktuvalik	(tuktuva)+lik
halraqtuk	(halr)+aqtuk
itkattuq	(itka)+t+tuq
ilphi	(ilp)+hi
ila	(ila)
amaaqtuq	(ama)+aq+tuq
apkaluktaqtuq	a+(pkalukt)+aq+tuq
haulluun	(haullu)+un
higjaq	(higja)+q
hinaani	hi+(na)+ani
ivjuhiliqtaa	(ivjuhil)+iq+taa
atuqtaa	(a)+tuq+taa
aingittuq	a+(ing)+it+tuq
hiurjuktuuq	hi+(urjuk)+tuuq
aqhaluktuq	(aqha)+luk+tuq
itiruq	(iti)+ruq
qunmuktuq	(qunm)+uk+tuq
tammaijaa	(tammai)+jaa
aannuraariiqtuq	(aannuraa)+riiq+tuq
aanniaqtailiniq	a+(anniaqtaili)+niq
akulliqun	a+(kulliq)+un
imnaiq	(imna)+iq
hitiliuqtuq	(hiti)+liuq+tuq
kakillarnaq	ka+(killarna)+q
unnirluktuq	(unni)+rluk+tuq
puijuq	(pui)+juq
taimak	ta+(ima)+k
tui	(tui)
iluviqtaa	(iluv)+iq+taa
angivittuq	ang+(iv)+it+tuq
inikhaqqukittuq	(inikhaqqu)+kit+tuq
qipiktaa	qi+(pik)+taa
akhatquq	a+(khatq)+uq
puvitqurnaqtuq	puvi+(tqur)+naq+tuq
quagjuk	qu+(agj)+uk
uliisiqtuq	(uliis)+iqtuq
ikuttiaqtuq	(ikutti)+aq+tuq
nigiqtuq	(nig)+iqtuq
imuniq	(imu)+niq
mahaktuq	(mah)+ak+tuq
uvagut	(uvag)+ut
qalluti	(qalluti)
havgut	(havg)+ut
mitquit	(mitqu)+it
iiqtuq	(i)+iqtuq
uuktuqtaa	(uuk)+tuq+taa
unnukpat	(unnuk)+pat
aullarnanga	a+(ullarna)+nga
niglaktuq	n+(igl)+ak+tuq
init	(in)+it
pualuk	(pualu)+k
iqalukhiuqtuq	(iqaluk)+hiuq+tuq
iqilgagiaq	(iqilgagi)+aq
ugjuk	(ugju)+k
imiqtaqti	(imiqt)+aq+ti
minguliq	(minguli)+q
niuqqaqtuq	(niuqq)+aq+tuq
kiilliq	ki+(i)+lliq
halumajuq	(haluma)+juq
hivu	(hivu)
nigaqtuq	(nig)+aq+tuq
nutiblik	(nutib)+lik
understand	(understand)
ikittijuq	(iki)+ttijuq
aaktuut	a+(aktu)+ut
nipliqtuq	n+(ip)+liq+tuq
urjuk	(urju)+k
anguniaqti	ang+(uni)+aq+ti
qaamiutaq	qa+(a)+miutaq
qanniq	qa+(n)+niq
akun’nganiittuq	(akun’ngani)+it+tuq
qattiniq	qa+(tti)+niq
marlungajuq	m+(arlunga)+juq
urviujaq	(urviuj)+aq
nagligijaa	(nagli)+gijaa
anarnat	a+(narna)+t
ivalukhaun	(ivalukha)+un
attirniit	att+irni+(i)+t
akituvallaaqtuq	(akituvall)+aaq+tuq
anngut	(anng)+ut
aqubliqtuq	a+(qubl)+iqtuq
qun’ngiaqtuq	qu+(n’ngi)+aq+tuq
tunutaa	(tunu)+taa
aunginnannguqtuq	a+(unginnannguq)+tuq
piksaliut	(piksali)+ut
angitqijaq	ang+(itqij)+aq
havaktuq	(hav)+ak+tuq
tingittaitkun	(tingittai)+t+kun
umik	(u)+mik
nauligaq	(nauli)+gaq
aippiut	(aippi)+ut
niqiliqivik	niqi+(liqi)+vik
uqhurjuaqtauti	(uqhurjuaqta)+uti
kipaqati	(kipa)+qati
higaakuvik	(higaaku)+vik
hivajauti	hi+(vaja)+uti
makaqhuqtuq	(makaq)+hu+qtuq
hiqiraqtuq	(hiqir)+aq+tuq
ilgaak	(ilga)+ak
ajuqhittuq	a+(juqh)+it+tuq
iritaqtuq	(irit)+aq+tuq
kigutigikhaut	kigu+(tigikha)+ut
tarrijaut	(tarrija)+ut
hamma	(hamm)+a
imaiqtaa	(ima)+iq+taa
kiglingani	ki+(gling)+ani
paatuliiq	paa+(tuli)+iq
qin’ngaut	(qin’nga)+ut
qulittaq	qu+(litta)+q
amrit	(am)+rit
tikitinnanuk	(tikitinna)+nuk
aittuuti	(aittu)+uti
hamna	(ham)+na
atiq	a+(ti)+q
iliffi	(ili)+ffi
anaujaa	a+(nau)+jaa
algumuuqtuq	a+(lgumuuq)+tuq
aki	(aki)
huraaqhiuqtuq	(huraaq)+hiuq+tuq
illaujaq	(illauj)+aq
tivjariktuq	(tivja)+rik+tuq
kimikatiqaqqin	(kimikatiqa)+qqin
nagjungmiktaa	(nagjung)+mik+taa
hatqiqtuq	(hatq)+iqtuq
patau	(patau)
qaplunaaq	(qaplu)+naaq
tingittaipkun	(tingittai)+pkun
arvinilitpingahuat	(arvini)+lit+pinga+hu+at
ukkuhikhaq	(ukkuhi)+khaq
im’run	(im’r)+un
nuijaaqpak	n+(uijaaq)+pak
aumaliuqtuq	(auma)+liuq+tuq
munaqhi	(mu)+naqhi
qajaq	(qaja)+q
aullaqtinnanuk	aullaq+(tinna)+nuk
malruuktaqtut	malru+(uk)+taq+tut
mivvik	(miv)+vik
haputi	(hap)+uti
aquani	(aqu)+ani
akiruq	(aki)+ruq
arnalluq	(arnall)+uq
kakivak	ka+(ki)+vak
kapuraun	(kapura)+un
nakitqaivit	(nakitqai)+vit
mamianaq	(mamia)+naq
uitajuq	(uita)+juq
inukkat	(inu)+kkat
qurluqtuq	(qurluq)+tuq
agiaqtuq	(agi)+aq+tuq
puptajuq	(pupta)+juq
maamaktuq	(maamak)+tuq
aliqak	(aliqa)+k
iviangiilitaq	(iviangi)+ilitaq
kiluuttaq	(kiluutt)+aq
titqaun	(titqa)+un
irnikhaq	(irni)+khaq
kigliq	(kig)+liq
maniilaq	(maniil)+aq
aluijarvik	a+(luij)+arvik
puvalajuq	(puvala)+juq
ivik	(i)+vik
qiuvik	qi+(u)+vik
naammajjavutit	(naammajjavu)+tit
kangiqhimanngittuq	kang+(iqhima)+nngit+tuq
tii	(tii)
itquqtuq	(itquq)+tuq
anarvik	a+(n)+arvik
imaruqtivia	(imaruqtivia)
itingmiktaa	(iting)+mik+taa
tahinnuaq	(tahi)+nnuaq
apqut	(apqu)+t
aihiqtuq	a+(i)+hiq+tuq
mikhijuq	(mik)+hi+juq
pataliqun	(pata)+liq+un
titqiaq	(titqi)+aq
iquutikhaut	(iquutikha)+ut
naunaitkutaq	(naunaitk)+ut+aq
irniq	(ir)+niq
quglugiaq	(quglu)+gi+aq
hungajangajuq	hu+(ngajanga)+juq
aluktaa	(aluk)+taa
qiuk	qi+(u)+k
attiaq	a+(tti)+aq
agiraq	(agir)+aq
kauttuaq	ka+(uttu)+aq
nangutaa	(nangu)+taa
itiktaqtuq	(itik)+taqtuq
nakuujuq	(nakuu)+juq
pinniqtuq	(pinn)+iqtuq
havilqhiaq	havi+(lqhi)+aq
uviluq	(uvil)+uq
ataaguuqtaa	(ataagu)+uq+taa
iluittunnguqtuq	(iluittunn)+guq+tuq
itiq	(iti)+q
angajun’nguq	(angaju)+n’nguq
kivijuq	ki+(vi)+juq
numiktirijuq	numik+(tiri)+juq
nipalliqtuq	(nipal)+liq+tuq
tupaktuq	(tup)+ak+tuq
itqanaijaqtuq	(itqana)+ijaqtuq
unnuliqtuq	(unnu)+liq+tuq
arvinilithitamaat	(arvini)+lit+hi+tamaat
akuqtujuq	a+(kuqt)+ujuq
ivalukhaq	(ivalukha)+q
inuk	(inu)+k
naarliqtuq	(naar)+liq+tuq
mahak	(mah)+ak
havangtinnanga	havang+(tinna)+nga
ilitarnaqtuq	(ilitarn)+aq+tuq
taliqpiani	(taliqpi)+ani
tarraq	(tarraq)
ajurnarmat	(ajurnar)+ma+t
niviuvarjuk	(niviuva)+rj+uk
nattiq	(natt)+iq
nungulaittumun	(nungulaittum)+un
akiraqtuqtuq	(akiraq)+tuq+tuq
qajainnaq	(qaja)+innaq
aputaijaijuq	(aputaij)+aijuq
qaalluviaq	qa+(alluvi)+aq
aikhiutijaa	a+(ikhiuti)+jaa
pukuktuq	(puk)+uk+tuq
ivajuq	(iva)+juq
qinmiqpak	qinmi+(q)+pak
aullaqtinnatik	aullaq+(tinna)+tik
amaruq	(ama)+ruq
nirrit	(nirri)+t
apqutailiutaujuq	(apqutailiuta)+ujuq
qaplunaavjak	(qaplu)+naavjak
ilagiik	(ila)+giik
kiahik	ki+(ahi)+k
pualritiik	(pualri)+tiik
aijaa	(ai)+jaa
kigun	(kig)+un
aulattiji	(aulatti)+ji
nahaq	(naha)+q
tunin’nguitkutikhaq	(tunin’nguitk)+utikhaq
humunngauyit	(hu)+munngau+yit
natiruvilaqijuq	(natiruvi)+laqi+juq
putuligaq	putu+(li)+gaq
akitujuq	a+(kitu)+juq
mikilirarmiaq	(mikilir)+armiaq
angunnait	angun+(na)+it
tuhaqtuq	(tu)+haq+tuq
tamaita	(tama)+ita
angak	(ang)+ak
agluliuqtuq	(aglu)+liuq+tuq
ata	(a)+ta
angmagiaq	(angma)+gi+aq
aqilgivik	a+(qilgi)+vik
qapalaqijuq	qa+(pa)+laqi+juq
kauttuarminunngaqtaa	ka+(uttuarmi)+nunngaq+taa
hitaakik	(hitaaki)+k
tiguaq	(tigu)+aq
qujahuktuq	(quja)+huk+tuq
angujuq	(angu)+juq
atanikittuq	a+(tanik)+it+tuq
naittuq	(na)+it+tuq
qin’ngurluktuq	(qin’ngu)+rluk+tuq
tiguaqhiik	(tiguaqhiik)
atuqtuq	(a)+tuq+tuq
ilikkuuqtuq	(ili)+kkuuq+tuq
tatqiqhiut	(tatqi)+qhi+ut
humi	(humi)
akit	(aki)+t
tuffiuqtuq	(tuffiuq)+tuq
kigulliuqtuq	kigu+(l)+liuq+tuq
taliqpingmuuqtuq	(taliqpi)+ngmuuq+tuq
nujuittuq	(nuju)+it+tuq
pilaut	(pila)+ut
naliat	(nali)+at
angunahuaqtuq	angun+(ahu)+aq+tuq
hiitquaqtuq	(hiitqu)+aq+tuq
tiiliurun	(tiiliur)+un
piiqtuq	(pi)+iqtuq
kajuqtuq	ka+(juq)+tuq
ulrujaaqtuq	(ulruj)+aaq+tuq
amaulikkaaq	(amaulikka)+aq
qanik	(qani)+k
avgut	(avg)+ut
angilrauliqtuq	(angilrau)+liq+tuq
huqqaq	hu+(qqa)+q
quinangnaqtuq	qu+(inang)+naq+tuq
ikkitit	(ikki)+tit
avguumattiarniq	(avguumattiar)+niq
uqittuq	(uq)+it+tuq
ajakutaaq	a+(jakuta)+aq
iliphi	(iliphi)
hiqquqtijjuti	(hiqquqtijj)+uti
kaugvik	ka+(u)+g+vik
tungungajuq	(tungunga)+juq
tatqiq	(tatqi)+q
tamuajuq	ta+(mua)+juq
aiktautituq	a+(iktauti)+tuq
ihaqutait	(ihaquta)+it
katittait	ka+(titta)+it
kuplu	k+(uplu)
pikijuq	p+(iki)+juq
inuinnaq	(inu)+innaq
titiraqtaa	(titir)+aq+taa
niujjivik	(niujji)+vik
algaun	(alga)+un
qilgiqtuq	(qilgiq)+tuq
mumiqtuq	(mum)+iqtuq
aniqhaaktuq	a+(niqha)+ak+tuq
uqumaittuq	(uquma)+it+tuq
qiliqtaa	(qil)+iq+taa
iijji	(iijji)
kiguhiqquti	kigu+(hiqq)+uti
auviq	(auv)+iq
aukhittiaqhimaittuq	a+(ukhittiaqhima)+it+tuq
huluk	hu+(lu)+k
qimirluk	qi+(mi)+rluk
nauk	n+(a)+uk
nigaqtaa	(nig)+aq+taa
aukhiqtuqtuq	(aukh)+iqtuq+tuq
kiguhiqqut	kigu+(hiqq)+ut
iqalgagiaq	(iqalga)+gi+aq
nipikhaun	n+ipik+(ha)+un
tajjagu	(tajja)+gu
tuvaaq	(tuva)+aq
uilgaqtuq	(uilg)+aq+tuq
tatqamunga	(tatqamu)+nga
havaliqtut	(hava)+liq+tut
ajjikiiktuk	(ajjikiiktuk)
quana	qu+(a)+na
qujajuq	(quja)+juq
tahin’ngajuq	ta+(hin’nga)+juq
iharuq	(iha)+ruq
tugliq	(tugliq)
algiqtuq	a+(lg)+iqtuq
iijjiraaluk	(iijji)+raaluk
nakuugijaa	(nakuu)+gijaa
aqiatuhuktuq	(aqiatu)+huk+tuq
utimut	(utim)+ut
ipummingajuq	(ipumm)+ingajuq
aullaqtinnata	aullaq+(tinna)+ta
iqhinaqtuq	(iqhi)+naq+tuq
qaluiraqtuq	qa+(luir)+aq+tuq
huli	(huli)
tatattaa	ta+(tat)+taa
pinahugijaa	p+(inahu)+gijaa
unaguiqhiqtuq	una+gu+(iqhiq)+tuq
aulajuq	a+(ula)+juq
anuraiqtuq	(anura)+iqtuq
nigituraqtuq	(nigitur)+aq+tuq
ikhun	(ikh)+un
ukiaq	(ukia)+q
aannuraaqtuq	(aannuraaq)+tuq
ataatattiaq	a+(taata)+ttiaq
taliqpimni	(taliqpi)+mni
kanna	ka+(nna)
uittuq	(u)+it+tuq
kinnguqtaa	ki+(nng)+uq+taa
ubluliuqtuq	(ublu)+liuq+tuq
ukiuqtuq	(ukiuq)+tuq
pualriti	(pualri)+ti
qiluktuq	(qi)+luk+tuq
aajjigijaa	a+(ajjigijaa)
ituk	(it)+uk
kipijaa	ki+(pi)+jaa
apqutaiqtuq	(apquta)+iqtuq
uanmun	(uanm)+un
ukiuq	(ukiuq)
pattitigijaa	(pattiti)+gijaa
augiaq	a+(u)+gi+aq
hilarjuaq	(hila)+rj+uaq
irinahuktuq	(irina)+huk+tuq
higaarjuaq	(higaa)+rj+uaq
tatatpiaqtaa	ta+(tatpi)+aq+taa
niujaujuq	(niuja)+ujuq
qalvaaq	(qalva)+aq
nattiaq	(na)+ttiaq
nuliaq	(nu)+liaq
haqiktuq	(haqik)+tuq
ikajuqti	(ikajuq)+ti
kinauvit	ki+(nau)+vit
angiglijuq	ang+(igli)+juq
kapurauti	(kapura)+uti
katimavik	ka+(tima)+vik
kingullirmi	(kingullir)+mi
nanuq	(nanuq)
pigaaqtuq	p+(iga)+aq+tuq
ilaaqtuqtaa	(ilaaq)+tuq+taa
uqauhirijaa	(uqauhi)+rijaa
publa	publ+(a)
hunagaijaijuq	huna+(gaij)+aijuq
itqujaq	(itquj)+aq
taffi	(ta)+ffi
anmut	(anm)+ut
an’rajuktuq	a+(n’raj)+uk+tuq
kappiagijaa	(kappia)+gijaa
tikittuq	(ti)+kit+tuq
akiraqtuqtaa	(akiraq)+tuq+taa
atauhiq	(atauhi)+q
nibliqtuq	(nibl)+iqtuq
kammak	(ka)+mmak
qalahiq	qa+(lahi)+q
tiriajaaq	(tiriaja)+aq
ahiqquq	a+(hiqq)+uq
ilihaqtaa	(ilihaq)+taa
tiriaq	(tiri)+aq
nikhaaktuq	(nikha)+ak+tuq
humunngaqqa	hu+(munngaq)+qa
qumniq	(qum)+niq
puujjuktuq	p+(uujj)+uk+tuq
tirikhaq	(tiri)+khaq
tuqhualiqiji	(tuqh)+ualiqiji
uniq	(u)+niq
talvatuaq	(talva)+tuaq
aullaqtinnagu	aullaq+(tinna)+gu
aullarnatik	a+(ullarna)+tik
makkaq	(makk)+aq
ikpingnarniq	(ikpingnar)+niq
qaajurnaqtuq	qa+(ajur)+naq+tuq
paniqhiivik	(paniqhii)+vik
quanaqtuq	qu+(a)+naq+tuq
atqit	(atq)+it
nipitqaqtaut	(nipitqaqta)+ut
tiiliurvik	(tiiliur)+vik
makitaa	m+(aki)+taa
pingahut	(pingahu)+t
aquijuq	(aqui)+juq
alaiqtuq	a+(la)+iqtuq
ilaani	(ila)+ani
aquut	(aqu)+ut
ihumaittuq	(ihuma)+it+tuq
qimiriaq	qi+(mi)+riaq
tuqujuq	(tuqu)+juq
kukiktaa	(kukik)+taa
aqilummaaq	a+(qilumm)+aaq
itqarijaa	(itqa)+rijaa
taiguaqtuq	(taigu)+aq+tuq
arvinilik	(arvini)+lik
higguk	(higgu)+k
iglugiik	(iglu)+giik
taqturun	ta+(qtur)+un
attirniik	att+irni+(i)+k
imani	(im)+ani
kivanmun	(kivanm)+un
haqiktaut	(haqikta)+ut
huliva	(huli)+va
aittuutigijaa	(aittuuti)+gijaa
amaamakhaq	a+(maama)+khaq
angajugiit	(angaju)+giit
nungulaittumut	(nungulaittum)+ut
uquiqtuq	(uqu)+iqtuq
pitikhuqtuq	(pitik)+hu+qtuq
situa	situ+(a)
nirihuiqtinnanga	(niri)+huiq+tinna+nga
allaijaijuq	(allaij)+aijuq
apiqhijuq	(api)+qhi+juq
hitaakiq	(hitaaki)+q
ikuutaq	(ikuut)+aq
tikinnahi	tikin+(na)+hi
qiplaqhiqtuq	(qiplaqh)+iqtuq
tariurnittuq	tariu+(rn)+it+tuq
nutaqqijuq	n+(utaqqi)+juq
qulliq	(qu)+lliq
niritinnagit	niri+(tinna)+git
aajjikkutaa	a+(ajjikku)+taa
nutaqqat	(nuta)+qqat
aavaqtuq	(aav)+aq+tuq
hulivin	(huli)+vin
sikiiraqtuq	(sikiir)+aq+tuq
angirjuaq	a+(ngi)+rj+uaq
uugaq	(uu)+gaq
mmaamak	m+(maamak)
nangiarnaqtuq	(nangiar)+naq+tuq
uqhurjuaq	(uqhurjua)+q
angilrarvik	(angilr)+arvik
aquplingajuq	(aqupl)+ingajuq
nuna	(nuna)
aarluqtuq	(aarluq)+tuq
anuqhiqtuq	(anuqh)+iqtuq
tallak	(ta)+llak
tamapta	(tamap)+ta
himmauhiktaa	hi+(mmauhik)+taa
qiqaijaluarvia	qi+(qaijaluarvia)
napariaq	(napa)+riaq
quunilaqijuq	qu+(uni)+laqi+juq
kipkaq	(kipka)+q
hivullirmik	hi+(vullir)+mik
akimajuq	(akima)+juq
tunmiraq	(tunmira)+q
akkiutaq	a+(kki)+ut+aq
amiiqtaa	(ami)+iq+taa
maamaut	(maama)+ut
tupagumitaaqtuqtuq	tupag+(umitaaq)+tuq+tuq
hivuniq	(hivu)+niq
pilgujuq	p+(ilg)+ujuq
qitirmiut	qi+(tir)+miut
utkuhikhaq	(utkuhi)+khaq
wantsmore	(wantsmore)
ammak	(a)+mmak
auguiqtuq	(augu)+iqtuq
haujaa	(hau)+jaa
iguttaq	(igutt)+aq
ihaqqut	(ihaqq)+ut
ilujuq	(il)+ujuq
pingahuraaqtuq	(pingahu)+raaq+tuq
pitikhik	(pitik)+hik
kuungajuq	(kuunga)+juq
ajjigijaa	(ajjigijaa)
aajjigiiktuk	a+(ajjigiiktu)+k
anik	a+(ni)+k
qijuk	qi+(juk)
arjaijarvik	(arjaij)+arvik
qamauk	qa+(mauk)
apittaaq	(api)+ttaaq
quinaktuq	(quin)+ak+tuq
aaktuqtuq	a+(ak)+tuq+tuq
hikunngiqtuq	hiku+(nng)+iqtuq
piksa	p+(iksa)
iluviq	(iluv)+iq
anikkurijuq	(anikkuri)+juq
huvak	(hu)+vak
ihaqutaq	(ihaquta)+q
nirjun	(nirj)+un
iluani	(ilu)+ani
kapijaa	ka+(pi)+jaa
kanangnaqtuq	ka+(nang)+naq+tuq
kannguhuktuq	ka+(nn)+gu+huk+tuq
nipitirun	(nipitir)+un
atqun	(atq)+un
nuliilgahuk	(nuliilg)+a+huk
aallangajuq	(aallanga)+juq
uqquuqun	(uqquuq)+un
anmun	(anm)+un
inukpagjuaq	(inukpagju)+aq
akulrutaaqtuq	a+(kulruta)+aq+tuq
atqunarnirujuq	(atqunarniru)+juq
qilalugaq	(qilalug)+aq
taluquaq	(taluqu)+aq
uniaqtaa	(uni)+aq+taa
huqullaaqtuq	hu+(qull)+aaq+tuq
tuqungajuq	(tuqunga)+juq
naluktuq	(na)+luk+tuq
hivunniriiqtuq	hivun+(niri)+iqtuq
qaluraun	(qalura)+un
qirnariktuq	qi+(rna)+rik+tuq
katittut	(kat)+it+tut
milugiaq	(milu)+gi+aq
naammajjavuhi	(naammajjavu)+hi
nujaiqtuq	(nuja)+iqtuq
hila	(hila)
quanaqpiaqqutit	(quanaqpiaqqu)+tit
kiijaa	ki+(i)+jaa
tigliktuq	(tiglik)+tuq
hainngihuktuq	(hainngi)+huk+tuq
angmajuq	(angma)+juq
nigaq	(nig)+aq
uplaami	(uplaa)+mi
kihaq	(kih)+aq
qilaaq	(qila)+aq
qakuguliqaak	(qakugu)+liqaak
takhijuq	(tak)+hi+juq
amaqqut	(ama)+qqut
ilgak	(ilga)+k
inikhaittuq	(inikha)+it+tuq
ungalaq	(ungal)+aq
aannuraat	(aannuraa)+t
mihuraq	(mihur)+aq
situasaaluti	situ+(asaal)+uti
pallukaqtuq	p+(alluk)+aq+tuq
arnannait	a+(rnanna)+it
qimujuittuq	qi+(muju)+it+tuq
tipaittuq	(tipa)+it+tuq
kakilahaijuq	(kakilah)+aijuq
avguijuq	(avgui)+juq
taijaa	ta+(i)+jaa
umingmaaq	umingma+(a)+q
tarraqtuqtuq	(tarraq)+tuq+tuq
kamngit	k+(a)+mngit
aulatti	(aulatti)
tallimat	(talli)+ma+t
qavvik	qa+(v)+vik
tuvirrat	(tuvirrat)
aqu	(aqu)
qakuqtaq	qa+(kuqt)+aq
kublu	(ku)+blu
uuktuqtuq	(uuk)+tuq+tuq
arviq	(arv)+iq
niaqurluktuq	(niaqur)+luk+tuq
ingniquti	(ingniq)+uti
ikittaun	(ikitta)+un
qilirniq	(qilir)+niq
quviahuujuq	(quviahu)+ujuq
pamialluk	(pamiall)+uk
imiqtaun	(imiqta)+un
kuvjaqtaa	(kuvj)+aq+taa
igluaq	(iglu)+aq
kitkut	ki+(tk)+ut
havangnatin	havang+(na)+tin
qaluraut	(qalura)+ut
ublukittuq	(ublu)+kit+tuq
haunittiariik	(haunittia)+riik
unnuaq	(u)+nnuaq
aippaagu	(aippaagu)
kakilahak	(kakilah)+ak
aagut	a+(ag)+ut
umilruk	(umilr)+uk
iigijaa	(ii)+gijaa
anujijuq	(anuji)+juq
algaak	(alga)+ak
iliranaqtuq	(ilira)+naq+tuq
avataani	(avata)+ani
aqaguunnukpat	aqagu+(unnuk)+pat
tikitaa	(tiki)+taa
takujaa	ta+(ku)+jaa
mitqun	(mitq)+un
kikkariktuq	ki+(kka)+rik+tuq
minguktaa	(minguk)+taa
hilalliq	(hila)+lliq
auktirut	(auktir)+ut
ilihaiji	(ilihai)+ji
nakahungnaq	(nakahung)+naq
hamanirmiut	(hamanir)+miut
nigaqtuqtuq	(nigaq)+tuq+tuq
itipjaaqtuk	(itipja)+aqtuk
tunihijuq	(tuni)+hi+juq
nipittuq	(nipi)+t+tuq
tipi	(tipi)
aappak	(aappa)+k
ikaaqtuq	(ika)+aq+tuq
patuqun	(patuq)+un
alianaigijaa	(alianai)+gijaa
angmaqtirun	(angmaqtir)+un
alilajuq	(alila)+juq
makpiraqtuq	(makpir)+aq+tuq
aajjikiiktuk	a+(ajjikiiktuk)
takkuani	(takku)+ani
alappaa	(alappa)+a
akin	a+(k)+in
ikaaraq	(ikaar)+aq
titiraut	(titira)+ut
annivik	(anni)+vik
kamik	ka+(mi)+k
napu	(napu)
millalauqtuq	(millalauq)+tuq
aumaallaktuq	a+(umaall)+ak+tuq
hukatirun	hu+(katir)+un
havangnani	havang+(nani)
patiriaqhijuq	(patiria)+qhi+juq
ikpiguhungniq	(ikpiguhung)+niq
iqhigijaa	(iqhi)+gijaa
quanaqpiaqqutik	(quanaqpiaqqu)+tik
ijjuaqhijuq	(ijjua)+qhi+juq
puptan	(pupta)+n
palriaqtaa	p+(alri)+aq+taa
pijumanngittuq	(pijuma)+nngit+tuq
nirlivik	(nirli)+vik
kajumiittuq	ka+(jumi)+it+tuq
aqhaliat	(aqhalia)+t
katittijuq	ka+(ti)+ttijuq
hingik	hi+(ngik)
qugluktaaqtuq	(quglukta)+aq+tuq
ukhuviaqtaq	(ukhuvi)+aq+taq
kingmingnak	ki+(ngmingna)+k
amiijaijuq	a+(miijai)+juq
puukattaq	(puukat)+taq
hikuuti	(hiku)+uti
uqaqti	(uq)+aq+ti
maraaqtuq	(ma)+raaq+tuq
ikimajuq	(ikima)+juq
pilaun	(pila)+un
aglu	(aglu)
ikkalruq	(ikka)+lruq
kapittuq	ka+(p)+it+tuq
pitikhaqtuq	(pitik)+haq+tuq
tikiq	(tiki)+q
kamiktuq	ka+(mik)+tuq
uluriahuktuq	(uluria)+huk+tuq
qarritijaa	qa+(rriti)+jaa
hivajaqtuq	(hivajaqt)+uq
tamuqtaa	(tamuq)+taa
talrit	(tal)+rit
kigut	(kig)+ut
qablu	(qablu)
nipitqaqtaun	(nipitqaqta)+un
iviangiq	(iviangi)+q
tigumiaqtaa	(tigumi)+aq+taa
kaiptaq	ka+(ipta)+q
tuktuvak	(tuktuva)+k
aullautijaa	aulla+(uti)+jaa
nulialik	nulia+(li)+k
piphi	(piphi)
mitqukittuq	(mitqu)+kit+tuq
uqpik	(uq)+pik
aiviq	a+(iv)+iq
navvannguqtuq	(navvann)+guq+tuq
qilgiqtaqtuq	(qilgiq)+taqtuq
aquti	(aq)+uti
qunguhiq	(qunguhi)+q
hivajaun	hi+(vaja)+un
ikilik	(iki)+lik
kakkiijauti	(kakkiija)+uti
nunakkuurutik	(nunakkuuru)+tik
kihiani	k+(ihi)+ani
angiqtuq	a+(ng)+iqtuq
uluagullik	ulu+(agul)+lik
akuruti	(akur)+uti
kijuaqtuqtuq	ki+(juaq)+tuq+tuq
qingalik	(qinga)+lik
nikpaqtuq	(nikp)+aq+tuq
nungutaa	(nungu)+taa
auma	(auma)
puvak	p+(u)+vak
qattinnaktuq	qa+(ttinn)+ak+tuq
amiq	(am)+iq
nipikhauti	n+ipik+(ha)+uti
qunmuujuq	qu+(nmu)+ujuq
tajarniq	ta+(jar)+niq
qalruttuq	(qalru)+t+tuq
qunguhiqtaun	(qunguhi)+qta+un
tuvak	(tu)+vak
uhiliqpallaaqtuq	(uhi)+liq+pallaaq+tuq
aqagumunngaqqqat	aqagu+(munngaq)+qqat
takhijaa	(takhi)+jaa
aarluktuq	(aa)+rluk+tuq
arnaq	(ar)+naq
ippakhat	(ippakha)+t
pilauti	(pila)+uti
tuquttijuq	(tuqu)+ttijuq
atauttikkun	(atautti)+kkun
ugjulik	(ugju)+lik
ukalaaq	(uka)+laaq
quaqhalaarut	(quaqhalaar)+ut
ingattaqtuq	(ingatt)+aq+tuq
hitujuq	(hitu)+juq
im’ruti	(im’r)+uti
hivajaqtaaqtuq	(hivajaqt)+aaq+tuq
ihumagijaa	(ihuma)+gijaa
pingattiut	(pingatti)+ut
qiqailruq	qi+(qa)+ilruq
kappiahuktuq	(kappia)+huk+tuq
aqagu	(aqagu)
tigvaqtuq	(tigv)+aq+tuq
kakkiijaun	(kakkiija)+un
apluqtuq	a+(pluq)+tuq
kivjautik	ki+(vjau)+tik
naniriaq	(nani)+riaq
in’ngaqtuq	(in’ng)+aq+tuq
tariukkuuqtuq	tariu+(kkuuq)+tuq
uhiijaqtuq	(uhi)+ijaqtuq
ani	(a)+ni
nutqaqtuq	(nutq)+aq+tuq
qanait	qa+(na)+it
kukiktuq	(kukik)+tuq
qaniriktuq	(qani)+rik+tuq
tingiq	(ting)+iq
nukariit	nuka+(rii)+t
tunujaq	(tunujaq)
uujuq	(u)+ujuq
miluilitaq	(milu)+ilitaq
quijuq	qu+(i)+juq
qakuqhijuq	qa+(ku)+qhi+juq
taaqhivalirvia	ta+(aqhival)+irvia
uaqhijuq	(uaqhi)+juq
ilannariik	(ilanna)+riik
nuliilgaqtuq	(nuliilg)+aq+tuq
piritaa	(piri)+taa
qaqquliuqtuq	qa+(qqu)+liuq+tuq
qupanuaq	qu+(panu)+aq
kipihimajuq	ki+(pihima)+juq
ujuruk	(ujuru)+k
aliktuq	(alik)+tuq
aullaqtinnanga	aullaq+(tinna)+nga
qiviuq	(qivi)+uq
tuvjaqhijuq	(tuvja)+qhi+juq
uumman	(uumma)+n
aijaahiqtuq	(aijaahiq)+tuq
kaaktuq	(ka)+ak+tuq
annujjutijut	a+(nnujjutij)+ut
ublu	(ublu)
ulapqiujaqtuq	(ulapqiuj)+aq+tuq
taimaatun	(taima)+atun
taimaaqtuq	(taima)+aq+tuq
aqqaluakhaq	(aqqalua)+khaq
kingumut	ki+(ngum)+ut
paunngaq	(paunn)+gaq
kina	ki+(na)
ijaruqtuq	(ija)+ruq+tuq
angujaa	(angu)+jaa
paniqhijjiqturvik	(paniqhijjiqtur)+vik
pitiktaa	(pitik)+taa
panik	(pani)+k
nurraq	(nurra)+q
mahu	(mahu)
tuhugijaa	(tuhu)+gijaa
apquti	(apqu)+ti
ipummiqtuq	(ipumm)+iqtuq
