kivjautik	ki+(vja)+uti+k
atuqhimayunik	at+u+(q)+hima+yu+nik
anguti	a+(ng)+uti
iluliittuq	ilu+(li)+ittuq
allaijaijuq	a+ll+(aija)+i+j+uq
ikajuqtaujarialaqipluni	i+(kajuqtaujarialaqi)+plu+ni
inikhaqaqtuq	ini+(khaq)+a+qtuq
kinguniq	ki+(ngu)+niq
ai	a+(i)
ayuqharuirutikhainik	ayu+(qharuir)+utikh+a+i+nik
kivgaqtuidjutikhat	kivgaq+tu+(idj)+utikh+at
minguk	m+(ingu)+k
moderna	mode+(rna)
navvaq	na+v+(va)+q
qiamiqhuqtaa	qi+(amiqhu)+qtaa
munariniq	mu+na+(ri)+niq
tariukkuuqtuq	tari+(ukku)+u+qtuq
hinnaktuqtuq	hi+nna+(ktu)+qtuq
puvvitkuvit	puvvi+(tku)+vit
nakahuk	na+ka+(hu)+k
angilraqtuq	angi+(lra)+qtuq
amaaqtuq	a+(ma)+a+qtuq
iqhinaqtuq	iq+hi+(n)+a+qtuq
naammaktunga	naamma+(ktu)+nga
tikitinnatin	t+iki+(tinna)+tin
tingmiaqtuq	tingmi+(a)+qtuq
qaplunaatun	qa+pl+u+(naat)+un
atukpagaat	at+u+(kpaga)+at
kinguani	ki+(ngu)+ani
akujuq	a+(ku)+j+uq
alguangajuq	algu+(a)+nga+juq
hakhagiaq	ha+(kha)+gi+aq
kapuraut	ka+pu+(ra)+ut
milvik	mi+(l)+vi+k
nuvuja	nuvu+(ja)
pitquinikkut	pi+(tqu)+inikk+ut
milukattak	mi+lu+(katta)+k
nirumiktuq	ni+r+(umi)+kt+uq
qiniqtuq	qi+(n)+i+qtuq
ubluriaq) star	ub+lu+(riaq)+) st+ar
ingniqun	ing+niq+(u)+n
miluilitaq	mi+lu+(ili)+taq
hikun’riqtuq	h+iku+(n’r)+i+qtuq
qamittuq	qa+(mi)+tt+uq
nunaliqun	nuna+(liq)+un
kiviktaa	kiv+(i)+kt+a+a
ikkattuq	ik+(ka)+tt+uq
kiilliniq	ki+il+(li)+niq
aulalimaiguvit	aula+(limai)+guvit
auk	a+(u)+k
hitiliuqtuq	hit+(ili)+u+qtuq
qaffit	qa+(ffi)+t
nunanganut	nuna+(ngan)+ut
puvvillakkuvit	puvvi+(lla)+k+ku+vit
uqpiliurniq	u+q+p+(iliur)+niq
titirauyautikhainnik	tit+irauya+(utikha)+in+nik
piqpagiyagin	pi+(q)+pagiya+gin
nangmaktaq	nang+(mak)+taq
naqitlugu	na+(qit)+lu+gu
akituyuni	ak+(ituyu)+ni
nirihuiqtinnanga	niri+huiq+(tinna)+ng+a
ukpik	uk+(pi)+k
upalungaiqhimaguvin	up+a+lu+ng+(aiq)+hima+guvin
upalungaiyautini	u+pa+(lungaiya)+uti+ni
kidjangniq	ki+(dja)+ng+niq
ailaqtuq	a+(ila)+qtuq
makpiraqtuq	makp+(ir)+a+qtuq
akiraqtuqtaa	aki+(ra)+qtuq+taa
ivjuhiliqtaa	ivj+u+(hili)+qtaa
inuinnatnik	inuinna+(t)+nik
kihaqtuq	ki+(ha)+qtuq
pivikhaqautikhainik	pi+(vikhaqauti)+khai+nik
ronald	ro+(nald)
hamani	ha+(m)+ani
kautaujaq	ka+(uta)+uja+q
maliktakhat	mal+i+(ktakha)+t
uvattiannuaq	uv+attia+(nnu)+aq
malikhautikharniklu	mal+(ikha)+utikh+ar+nik+lu
hamunngauliqtuq	ham+unng+a+(u)+li+qtuq
nunavut	nuna+(v)+ut
kigutigikhaut	kigut+(igikha)+ut
pilaktaa	pi+(la)+kt+a+a
allujikkata	a+ll+(ujikk)+at+a
pitikhuqtuq	pi+ti+k+(hu)+qtuq
urviujaq	u+(rvi)+uja+q
pualritiik	pu+alri+(ti)+ik
hivayauytivinikkut	hivay+a+(uytivi)+nik+kut
akitujuq	aki+(tu)+j+uq
angijuugamik	angi+(juuga)+mik
qapuk	qap+(u)+k
ajurnarman	aju+(rna)+rma+n
namirmiutauyutin	na+(mi)+rmiut+auyut+in
paniqaqpunga	pa+ni+(qa)+q+punga
iiqtuqtuq	i+(iqtu)+qtuq
inirniq	i+(ni)+r+niq
irniq	(i)+r+niq
tulaktuq	tu+(la)+kt+uq
uaqhin	(uaqhi)+n
agluaq	a+(glu)+aq
hatqummiqtuq	ha+tqu+mmi+(qtu)+q
ihariagiyainniklu	iharia+(giyain)+nik+lu
imiraq	i+(mir)+aq
tuhugijaa	tu+(hu)+gijaa
pitjutiqaqtunik	p+(itjut)+iq+aqtu+nik
ihumaalugijaa	i+hu+(maalu)+gijaa
hulitjutit	huli+(tj)+uti+t
ungullaun	ungul+(la)+un
hanirarmiktuq	h+an+(irarmi)+kt+uq
uluaraut	u+lu+(ara)+ut
pittiaqhimayuni	pi+(ttiaq)+himayun+i
aannirnalaqinirmik	a+an+n+(irnalaq)+inir+mik
nakuukpiaktumik	na+ku+ukp+iak+t+(umi)+k
qilgiqtaqtuq	qilg+(iqta)+qtuq
qalviaq	qa+l+(vi)+aq
nampangit	na+(mp)+a+ngit
uqquuqut	uq+qu+(uq)+ut
ikpiguhuktuq	ik+pi+(guhu)+kt+uq
nunangini	nuna+(ngi)+ni
aqpik	(aqpi)+k
nunalaanilu	nuna+(laa)+nilu
tamagiik	t+ama+(gi)+ik
akiani	a+(ki)+ani
hiurjuut	hiurju+(u)+t
innuinaqtun	(innu)+in+aqtun
nauk	(na)+uk
pilutit	pi+(l)+uti+t
taffi	ta+(ffi)
atiliuqarnatik	at+ili+(uqarna)+tik
inugaq	inu+(g)+aq
itipjaaqtuq	(itipjaa)+qtuq
iiqtaa	i+(i)+qtaa
kapurhirvikhangit	k+apur+hirv+(ikha)+ngit
nutaaq	nu+(ta)+aq
qilluqiqtuq	qi+(lluq)+i+qtuq
apluriq	ap+(luri)+q
pingangnaq	pinga+(ngna)+q
apitilirvia	a+pit+(ili)+rvi+a
anguniaqtuliqiyitkunilu	a+ng+un+i+(aqtu)+liq+iyit+ku+nilu
atuqtuujaqtuq	at+u+(qtu)+uja+qtuq
ikayuutikhamutlu	ik+ayu+(utikha)+mut+lu
pikhiktuq	pi+(khi)+kt+uq
aulvik	a+(u)+lvik
akulliqun	(akulliq)+un
milukaqtuq	mi+lu+(k)+a+qtuq
tunulliq	tu+n+(ulli)+q
talvunga	ta+lv+(u)+ng+a
annaktuiliqiyutlu	annaktui+(liq)+iyut+lu
ukutitaq	uk+(utit)+aq
maligaliqiyitkutni	mal+i+(ga)+liq+iyit+kut+ni
iptiittuq	ip+(ti)+ittuq
inuuhimayuq	inu+(u)+hima+yuq
ikipkaqtaa	ik+(ipka)+qtaa
aahanngiq	a+(a)+hanngiq
maliqayukhauyut	mal+i+(qa)+yukh+auyut
ihumaliuqtut	i+hum+(ali)+uq+tut
hilaqqiqtuq	hila+(qq)+i+qtuq
iliuqpik	ili+(uqp)+ik
iqaluktuuttiap	iqa+luk+(tuutti)+ap
naunairutikharnik	naun+ai+(r)+utikh+ar+nik
puptan	pu+(pta)+n
qallun	(qa)+llu+n
tupaktuq	tu+p+(a)+kt+uq
uqaqatigijaa	uqa+(qatigi)+jaa
upluliuqtuq	u+pl+(uli)+u+qtuq
allarut	a+(llar)+ut
ataniuyunut	a+t+an+(i)+uyu+nut
aukhiriaq	auk+(hi)+riaq
hiuti	(hi)+uti
havangtinnagik	hav+ang+(tinna)+gik
an’ngajuktuqtuq	an’ng+aju+(ktu)+qtuq
kapihik	ka+(pihi)+k
hiqiqtuq	hi+(q)+i+qtuq
naunaipkutaq	na+una+ip+k+(uta)+q
aarluk	a+(arlu)+k
qiniqhiayunik	qin+iqhi+(a)+yu+nik
tugliq	tu+(gli)+q
ikuutaq	iku+(uta)+q
talvatuaq	ta+lv+(atu)+aq
haavraq	ha+(av)+raq
maniktaqvikhaq	man+ik+ta+(qvikha)+q
iqalaqiniriklu	iq+(alaqi)+nir+ik+lu
mamaittuq	ma+(ma)+ittuq
irniqaqpunga	irn+i+(qa)+q+punga
hingiq	hi+(ngi)+q
inuit	inu+(it)
ilitugipkainiq	ili+tug+ip+k+(a)+in+iq
makpiqhugit	makp+(iq)+hu+git
nunavunmi	nuna+(vunmi)
tupiqtuqtuq	tu+p+(iqt)+u+qtuq
hiqqaqtuq	hi+(qqa)+qtuq
illaijut	il+lai+j+(u)+t
qulliujaq	qu+l+(li)+uja+q
malikhautikhangit	mal+i+(kha)+utikh+a+ngit
ikualajuq	iku+al+a+(ju)+q
tititrarvikhaq	(titit)+r+ar+vikhaq
kiguhiqquti	ki+guhi+(qq)+uti
hiurjuun	hiurju+(u)+n
qaamiutaq	qa+a+(mi)+ut+aq
iqiahuujuq	(iqiahu)+u+juq
uquittuq	(uqu)+ittuq
pautik	pa+(u)+tik
apquhaaqtaa	ap+qu+(ha)+a+qtaa
taktakhat	ta+(ktakha)+t
uuktuuti	uuk+tu+(uti)
attiruaqtuq	att+ir+(u)+a+qtuq
havaktauyakhamut	hav+akt+(auyakham)+ut
tamainut	t+ama+(i)+nut
ilauvakhimayurlu	i+la+(u)+v+akhima+yurlu
aukhiqtuqtuq	auk+(hiqt)+u+qtuq
panikhaq	pa+(ni)+khaq
ikuttiaqtuq	iku+(tti)+a+qtuq
ihivjuraq	(ihivju)+raq
uplaami	u+pl+(a)+a+mi
pivagainnik	pi+(vaga)+in+nik
tautuktuq	ta+(utu)+kt+uq
titiqat	titiq+(a)+t
nanminikhadjutikharnik	na+nmin+(ikha)+dj+utikh+ar+nik
anguhalluq	ang+u+(hall)+uq
tuniuqhailutiklu	tu+ni+(uqhai)+lutik+lu
tukhiqtuq	t+uk+(hi)+qtuq
maniqaqtitauyunik	ma+ni+(qaqtita)+uyu+nik
putu	pu+(tu)
unaguittuq	u+na+(gu)+ittuq
kunit	(kuni)+t
kanangnaq	ka+na+(ngna)+q
atanilluaq	a+t+an+(illu)+aq
iliharvik	ili+ha+(rvi)+k
piyakhamingnut	pi+(yakha)+mi+ng+nut
angivittuq	angi+(vi)+tt+uq
pamiqhaaq	pa+mi+(qha)+aq
amigaittuni	amig+a+(ittu)+ni
tigluktaa	ti+(glu)+kt+a+a
ihivriurhinirnik	ihivr+i+(urhi)+nir+nik
qangamit	qa+(nga)+mit
aqhalialaqijuq	aq+ha+(li)+alaqi+juq
nuviqhaaq	n+uvi+(qha)+aq
qiliqtaa	qi+(li)+qtaa
allaliqtuq	a+ll+(ali)+qtuq
nunaptingnilu	nuna+(pting)+nilu
wantsmore	(wantsmore)
nunakkuurutik	nuna+(kkuur)+uti+k
pukuktuq	pu+(ku)+kt+uq
havakvia	hav+ak+(via)
qitirmiut	qi+(ti)+rmiut
iluviqtaa	ilu+v+(i)+qtaa
akhuuqtuq	ak+hu+(u)+qtuq
ikpan	ikp+(a)+n
itiqtuq	i+(ti)+qtuq
tunihilutik	tu+ni+(hi)+lutik
avguumattiarniq	av+guu+(mattiar)+niq
paniqhiivik	pa+n+iqhi+(i)+vi+k
qiiq	qi+(i)+q
upalungaikhimalutin	up+a+lu+ng+(aikhi)+ma+lutin
alikhaq	a+(li)+khaq
naunairutiqaqtukhaq	naun+ai+(rutiq)+aqtu+khaq
anaanattiaq	a+na+a+na+(tti)+aq
makitaa	ma+ki+ta+(a)
inungmit	inu+(ngmi)+t
patuqun	pa+(tuq)+un
ikayuutingit	ik+ayu+(ut)+i+ngit
ilitturipkaitjutikhanik	ili+t+turip+ka+(itj)+utikh+a+nik
niaqua	ni+a+qu+(a)
talafuutiqaqtutin	t+al+(afuu)+tiqaq+tut+in
angmaniq	a+(ngma)+niq
pikuk	pi+(ku)+k
palriaqtaa	pa+(lri)+a+qtaa
pihugaaqpakhutik	pi+hu+(gaaqpakh)+uti+k
laisiliqigaangata	lais+(iliqigaangata)
hain’riguhuktuq	hain+’ri+(guhu)+kt+uq
nakuuhivalliavikhaatigut	nakuu+hi+vall+iav+(ikha)+at+igut
ilauyut	i+(la)+uyut
igluqpakhanun	igluqpa+(kha)+n+un
hivayajjavat	hivay+a+(jja)+v+at
iqqakuuqti	iqqaku+u+(q)+ti
akuliariktuq	(akuliari)+kt+uq
tivjat	t+ivj+(a)+t
apqutikhaa	apq+ut+(ikha)+a
nakuuhivalliavikhaanutlu	nakuu+hi+vall+iav+(ikha)+anut+lu
akhaluun	a+(khalu)+un
aviktaa	a+(vi)+kt+a+a
immittuq	im+(mi)+tt+uq
qaplunaavjak	qa+pl+u+(naavjak)
tunganaqtumik	tu+(ngan)+aqtu+mik
hakuiqtuq	haku+(i)+qtuq
hitamauyunik	(hitama)+uyu+nik
naimajuq	na+(i)+majuq
natirluit	natir+(lu)+it
qigliktuq	qi+(gli)+kt+uq
pitjutikhangit	pi+(tj)+utikh+a+ngit
kaapiliut	ka+ap+(ili)+ut
qiniqhiayuliqiyut	qin+iqhi+a+(yu)+liq+iyut
tuhaajuq	tu+ha+(a)+j+uq
kapuqhirvikhat	ka+puq+hirv+(ikha)+t
piissak	pi+(issa)+k
haujaa	ha+(u)+jaa
ilihainirmun	ili+ha+(i)+ni+rmun
anniruhuktuq	anniru+(hu)+kt+uq
tunihimaanginaqtun	tu+ni+(himaangin)+aqtun
kammak	ka+(mma)+k
anmun	(an)+m+un
hulivin	huli+(vi)+n
laisikhanik	lais+(ikha)+nik
panik	(pa)+nik
ihuigiyauyut	i+hu+(igiyau)+yut
king loon	ki+(ng loo)+n
initujuq	ini+(tu)+j+uq
aullarnatik	a+ulla+(rna)+tik
pivallianikkut	pi+vall+i+(a)+nik+kut
qalvik	qa+(lvi)+k
katimadjutigiplugin	kat+ima+(djuti)+gi+plu+gin
tuqhualiqiji	tuq+hu+(a)+liq+iji
ukiungnaik	ukiung+(na)+ik
qimirutit	qi+(mir)+uti+t
ituk	i+(t)+uk
mitqun	mitqu+(n)
imiqtatikkut	(imiqta)+tik+kut
niguaqtauvakhimayuq	ni+g+(uaqtau)+v+akhima+yuq
uqaudjaupluni	uq+au+(dja)+up+lu+ni
hamlatkuni	ham+l+at+(kuni)
aulapkainirni	aula+pka+(i)+nir+ni
apquhiniq	ap+qu+(hi)+niq
ilvittauq	i+(lv)+it+ta+uq
ppaamnguliaq	ppa+(amnguli)+aq
qipiktaa	qi+(pi)+kt+a+a
nuvalqhiq	n+uv+al+(qhi)+q
pitquhiq	pit+q+uhi+(q)
taaksinut	ta+ak+si+(n)+ut
aqagumunngaqqqan	aqagum+unng+aq+q+(qa)+n
kukiijaun	ku+ki+(ija)+un
puvvinniqaliruvit	puvvi+(nni)+qa+liru+vit
uluak	u+lu+(a)+k
kutnut	(k)+ut+nut
havvarluktuq	hav+var+(lu)+kt+uq
havakpaktut	hav+a+(kpak)+tut
algak	alg+(a)+k
niritinnagit	niri+(tinna)+git
alugvik	a+(lu)+gv+ik
akikhilarutikhainut	aki+kh+il+(ar)+utikh+ai+nut
iqaluit	iq+a+lu+(i)+t
ilihautiniq	ili+ha+(uti)+niq
tahirmut	ta+(hir)+mut
tikinnata	t+iki+(nna)+ta
nakuujuq	na+(kuu)+j+uq
pitjutikhainnik	pi+(tj)+utikh+a+in+nik
kakivak	ka+k+(ivak)
uqajuittuq	uqa+(ju)+ittuq
niqinik	ni+(q)+i+nik
aqhalingialaqijuq	aq+halin+(gi)+alaqi+juq
haputi	ha+p+(uti)
imani	i+(m)+ani
ikayuqtauyumayumut	ik+ayu+(qtauyu)+ma+yu+mut
ahiqquq	a+hi+(qq)+uq
havakviani	hav+ak+(vi)+ani
kanguujaq	ka+(ngu)+uja+q
qalaktuqtuq	qa+l+(aktu)+qtuq
ikuhik	iku+(hi)+k
taloyoak	t+al+(oyoa)+k
arnaqhiun	arna+(qhi)+un
atanguyaupluni	at+a+(nguya)+up+lu+ni
imiqtautikkut	(imiqta)+ut+ikkut
titiqanut	titiq+(a)+nut
avikturniani	av+ikt+u+(rni)+ani
havagviqaqhutiklu	hav+a+gv+(iqaq)+hu+tik+lu
aavaqtuq	a+(av)+a+qtuq
tunihivaklhutik	tu+ni+(hivakl)+hu+tik
tunivaktuq	tu+ni+(va)+kt+uq
iluvruaq	ilu+v+(ru)+aq
ikayuqtaugiaqaqtuq	ik+ayu+qtau+(giaq)+a+qtuq
nipitqaqtauti	ni+pit+(qaqta)+uti
hanimut	ha+(ni)+mut
ukpirijaa	ukp+(i)+rijaa
nakuuyumik	nakuu+(yu)+mik
angujaktut	ang+u+(ja)+kt+ut
aqagumunngaqpat	aqagum+unng+aq+pa+(t)
itqanaijaqtuq	itq+a+n+(aija)+qtuq
iluittuq	ilu+(i)+tt+uq
kavamaliqinirmut	ka+(vama)+liq+inir+mut
mahuk	ma+(hu)+k
ilingnik	i+(li)+ng+nik
niuvailiqiyut	ni+uv+(ai)+liq+iyut
hakiak	ha+(kia)+k
niuviqtaa	ni+uv+(i)+qtaa
kijjaktuq	ki+(jja)+kt+uq
arvinilithitamaat	arvin+ilit+(hitama)+at
haffumunga	ha+(ffumu)+ng+a
ikayuqhutiklu	ik+ayu+(q)+hu+tik+lu
nirjut	ni+r+(ju)+t
qivjaq	qi+(vja)+q
titirarhimayut	titir+a+(r)+hima+yut
tuhutujuq	(tuhutu)+j+uq
utiqtuq	(uti)+qtuq
uaqhijuq	(uaqhi)+j+uq
arnarvik	a+(rna)+rvik
ikittut	ik+it+t+(ut)
ilaani	i+(la)+ani
tuluriaq	tu+(lu)+riaq
kipijuq	ki+(p)+i+j+uq
tahittuq	ta+h+(i)+tt+uq
maniyauyut	ma+(ni)+y+auyut
qitiraq	qi+(tir)+aq
tamnalu	ta+(mnalu)
ikayuriamikni	ik+ayu+(ria)+mik+ni
niriliqhutik	niri+(liq)+hu+tik
qqaajuqtuq	qq+aa+(ju)+qtuq
naluqhitkuvinluuniit	na+lu+(qhi)+tkuv+in+lu+u+ni+it
hamlatkunutlu	ham+l+at+(ku)+nut+lu
munaqhitkut	mu+na+(qhi)+tkut
uhiqtiqtuq	u+(hiqt)+i+qtuq
nujarluktuq	nu+(jarlu)+kt+uq
tarrijaun	(tarrija)+un
qimugjuk	qi+m+(ugju)+k
pidjutikhanik	(pi)+djut+ikha+nik
uvattiagu	uv+attia+(gu)
aannuraat	a+an+n+(ura)+at
naunaittaghainut	na+una+it+(tagha)+in+ut
iqaluktuuttiaq	iqa+luk+(tuutti)+aq
niuvrutikhalinikkut	niuvr+(utikhal)+inikk+ut
patuk	p+at+(uk)
tipaittuq	tip+(a)+ittuq
qaqqulaaqtaa	qa+q+qu+(laa)+qtaa
pangaliktuq	pa+ng+(ali)+kt+uq
huunngittuq	(huu)+nng+ittuq
aupajangajuq	au+pa+j+ang+(a)+j+uq
tamuqtuq	ta+(mu)+qtuq
kakillarnaq	ka+k+(illa)+rnaq
huliyutin	huli+(yu)+tin
pivikhaqaqtut	pivikh+a+(q)+aqtu+t
atuquyauyuq	at+u+(quya)+u+yuq
hittuqittuq	hit+(tuq)+ittuq
apirillaglagin	ap+(irillagl)+ag+in
atauttikkun	a+ta+utti+(kku)+n
takhiqtuq	t+ak+(hi)+qtuq
uliktuq	u+(li)+kt+uq
ilihimalugit	ili+(hima)+lu+git
algauti	alg+(a)+uti
nuutaanguqtiqhimayuq	nu+uta+ang+(uqtiq)+hima+yuq
uhuk	(uhu)+k
piliurnikkut	pi+(liur)+nik+kut
qaffinik ukiuqaqqin	qa+(ffi)+nik+ u+kiuqaq+qin
uminga	(umi)+ng+a
taaqtuq	ta+(a)+qtuq
quglugiaq	qu+glu+(giaq)
taunani	ta+(un)+ani
uliun	u+(li)+un
unaguhungniq	u+na+(guhu)+ng+niq
kingiktutuanguvut	kingik+tu+(tuanguv)+ut
inuqaqtuq	inu+(q)+a+qtuq
unipkaaq	un+(ipka)+aq
aallanguqtirivaktugut	aall+ang+uq+tir+(ivak)+tugu+t
uaqtakhat	u+(aqta)+khat
quaq	qu+(a)+q
uuktuut	uuk+tu+(u)+t
pilugit	(pi)+lu+git
orcs	(orcs)
piyaaami	pi+(yaa)+a+mi
ikaulaaqtuliqijit	ik+a+(ula)+aqtu+liq+iji+t
hikuut	hi+(ku)+ut
laisikhakkut	lais+(ikha)+kkut
aanniarvik	a+an+n+(i)+arvik
kangiqliniq	ka+ngi+(qliniq)
katittut	ka+(ti)+t+tut
nautkutigami	na+utku+(t)+igami
nunalllaanut	nuna+(lllaan)+ut
ilitagiyaangat	ilit+(agi)+yaang+at
iqalgagiaq	iq+al+(ga)+gi+aq
paniqhijjiqturvik	pa+n+iqhi+(jjiqtu)+rvik
taiguqtaa	ta+(igu)+qtaa
tuuqtuq	(tu)+u+qtuq
ukuaglu	u+ku+(a)+g+lu
igluqpainni	igluqpa+(in)+ni
ihuaqhigiagutitlu	i+hu+(aqhi)+giag+uti+t+lu
qikiqtarjuaq	qi+kiqta+(rju)+aq
niruarvia	ni+r+(ua)+rvi+a
hanaqidjutikhanginik	ha+n+aq+idjut+(ikha)+ngi+nik
laisikhamik	lais+(ikha)+mik
pihimaniq	pi+(hima)+niq
puvvivjagluni	puvvi+(vja)+g+lu+ni
imaruqtivia	ima+(ruqti)+via
attirniq	a+(tti)+r+niq
havangtinnanga	hav+ang+(tinna)+ng+a
uik	u+(i)+k
alvat	a+(lv)+at
niujjijuq	ni+(ujj)+i+j+uq
naunaiyaidjutikhaq	naun+a+iya+(idj)+utikh+aq
nciac	(nciac)
qagaaqtuq	qa+g+(a)+a+qtuq
tukkaliqtuq	t+uk+(ka)+li+qtuq
uqhurjuaptaut	uqhurjua+(pta)+ut
ilauqaqhimayut	il+au+(qaq)+hima+yut
hapununnga	ha+p+(unu)+nnga
qujajuittuq	quja+(ju)+ittuq
uvani	uva+(ni)
katitiqvikhangit	k+at+iti+(qvikha)+ngit
aittuun	a+(ittu)+un
hivuaq	hiv+(u)+aq
igjuk	i+(gju)+k
haqiktauti	ha+(qikta)+uti
iptiiqtuq	ip+(ti)+i+qtuq
kavamaliqiyut	ka+(vama)+liq+iyut
havikhaq	hav+(ikha)+q
aulaagianganik	aula+a+(gianga)+nik
ayuirhaqtillugillu	ayu+i+(rhaqtil)+lu+gi+llu
qilalugaaq	qi+la+(lu)+ga+aq
inukpagjuaq	inu+kp+(agju)+aq
manikkami	ma+ni+(kk)+a+mi
aupajaavjaktuq	aupajaa+(vja)+kt+uq
alaviitanik	al+a+(viit)+a+nik
uqhurjuaqarvik	uqhurjua+(qa)+rvik
nukakhaq	nu+(ka)+khaq
ipualik	ip+(ua)+lik
qaffinikukiuqaqqin	qa+(ffiniku)+kiuqaq+qin
tiggak	tig+(ga)+k
inirnikhaq	ini+(rni)+khaq
uqaudjiukharnik	uq+au+(djiu)+khar+nik
uqhurjuaq	uqhurjua+(q)
quanaqqutit	quana+qq+(utit)
upaktaa	up+(a)+kt+a+a
hivullirpaarmi	hivul+li+(rpa)+armi
qanaktaq	qan+(ak)+taq
ihuarijamingnik	i+hu+(arijami)+ng+nik
anijuq	a+ni+(ju)+q
iqittirinirmik	iq+it+(tir)+inir+mik
nunagiyauyut	nuna+(gi)+y+auyut
tikitinnahi	t+iki+(tinna)+hi
upalunggaiyaunikkut	u+pa+(lunggaiyau)+nik+kut
kattuaq	ka+(ttu)+aq
aqqaluaq	a+(qqalua)+q
arnaqati	arna+(qa)+ti
ipiraq	ip+(ir)+aq
havaktiuyukharnik	hav+akt+(iu)+yu+khar+nik
pingattiut	pinga+(tti)+ut
ilihaijjutigijaghamingni	ili+ha+(ijjutigijaghami)+ngni
pata	p+at+(a)
iqilgagiag	iq+(ilga)+giag
takhinanuaqtat	ta+(khi)+n+anu+aq+t+at
taaksiyautinut	ta+ak+si+(ya)+uti+nut
ayungnaqtunik	ayu+ngna+(qtu)+nik
ilauqaqtuq	i+la+(uq)+a+qtuq
kavamauyut	ka+(vama)+uyut
mitquit	mitqu+(i)+t
pidjutikharnik	(pi)+dj+utikh+ar+nik
takkuani	ta+(kku)+ani
havakviingit	hav+ak+(vi)+i+ngit
ivjarut	ivj+ar+(u)+t
qilauti	qi+la+(uti)
qamnguqtuq	qamngu+(qtu)+q
tamaini	t+ama+(i)+ni
angut	a+(ngut)
qanait	qan+(a)+it
tamuutijaa	ta+(mu)+utijaa
atuqtauhimayunik	at+u+(qtau)+hima+yu+nik
atuganik	at+u+(ga)+nik
upin’ngakhaq	upin’nga+(khaq)
haqpingajuq	haq+(pi)+nga+juq
hitaakik	hita+aki+(k)
tikittuq	(ti)+k+ittuq
tunuhiq	tu+n+(uhiq)
aulaaguvin	aula+(a)+guvin
aullaqtinnata	a+ull+aq+(tinna)+ta
ingilrutingnik	i+ngi+(lr)+ut+ingn+ik
aulanirmun	a+u+(la)+ni+rmun
amigaqhuutiqaqtunik	amig+aq+hu+(ut)+iq+aqtu+nik
takukhaujutuan	taku+(k)+haujutuan
tamaat	t+ama+(a)+t
titirauyaqnikkut	tit+irauya+(q)+nik+kut
aijuq	(a)+i+j+uq
aqaguttauq	aq+a+(guttauq)
atuaqtauti	at+u+(aqta)+uti
kivgaqtuidjutikhaniklu	kivgaq+tu+(idj)+utikh+a+nik+lu
illaijun	il+lai+j+(un)
havangtinnatik	hav+ang+(tinna)+tik
hiuraq	hi+(ura)+q
ilannaq	i+la+(nna)+q
qajjat	qa+(jja)+t
nalunaqtuq	na+lu+(na)+qtuq
hiitquaq	hi+itqu+(a)+q
sikiituuqtuq	si+ki+(ituu)+qtuq
laisikhaita	lais+(ikha)+ita
amigakhuutiliqiyunik	amig+ak+hu+(ut)+iliq+iy+u+nik
ahiaqtaqtuq	a+hi+(aqta)+qtuq
ayuikhautikhaniklu	ayu+(ikha)+utikh+a+nik+lu
ilihaijuq	ili+ha+(i)+j+uq
inuaqtamingnik	inu+(aqta)+mi+ng+nik
havagviingit	hav+a+gv+(i)+i+ngit
kuummiujaaqtuq	k+uumm+i+(u)+jaa+qtuq
qaijuq	q+(a)+i+j+uq
hinnariktuq	hi+(nnari)+kt+uq
tuphiuqtuq	tu+p+(hi)+u+qtuq
kina atqin	ki+(na )+a+t+qin
iqaluktuuttiamilu	iqa+luk+(tuutti)+a+mi+lu
aannuraaqtuq	a+an+n+(ura)+a+qtuq
titirauyaqningini	tit+irauya+(q)+ni+ngi+ni
ilihimajara	ilihi+(majara)
hivu	hiv+(u)
pihukhimmaaqtuk	pi+hu+(khimmaa)+qtuk
aippirniq	a+ipp+(i)+r+niq
anguniaqtiit	a+ng+un+i+(aqti)+it
manniliuqtuq	man+ni+(li)+u+qtuq
itimak	i+(tima)+k
ilitarijaa	ilit+(a)+rijaa
havaqaqpakhimayuq	hav+a+(q)+aq+p+akhima+yuq
ayuikhautikhainik	ayu+(ikha)+utikh+a+i+nik
pamiuqtuuq	pa+mi+(uqtu)+uq
ikayuutikhangit	ik+ayu+(utikha)+ngit
arnannait	arna+(nna)+it
hurluk	hu+(rlu)+k
qattarjuaq	(qattarju)+aq
ajaraaq	a+(jara)+aq
qaptirut	qap+(tir)+ut
munariyait	mu+na+(riya)+it
hanajahimajut	ha+na+(ja)+hima+jut
nanuq	na+(n)+uq
piksaliuti	pi+(ksaliu)+ti
nunavutip	nuna+(v)+utip
kuhiqtuq	ku+(hi)+qtuq
qanuriliurutikhanik	qa+nur+(iliur)+utikh+a+nik
aittaqtuq	a+(itta)+qtuq
quahijaaqtuq	qu+(ahi)+jaa+qtuq
tupagiaqtuq	tu+p+(agi)+a+qtuq
naniriaqturvik	na+niri+(aqtu)+rvik
haniraq	h+an+(i)+raq
hungaq	hu+(ng)+aq
arvak	(arva)+k
nipitqaqtaut	ni+pit+(qaqta)+ut
kinautjutikkut	ki+na+u+(tj)+ut+ikkut
uitapqaqtuq	u+it+apq+(a)+qtuq
aannirnalaqiniq	a+an+n+(irnalaq)+in+iq
ajjikiiktuk	a+(jjik)+i+iktuk
pivikhaqautinik	pi+(vikhaqauti)+nik
tunigiaqaqtun	tu+ni+(giaq)+aqtun
tuvirrat	t+uvi+(rra)+t
piannariangani	pi+anna+(ria)+ng+a+ni
piphi	pi+(phi)
auktiruti	auk+(tir)+uti
nutaqqak	n+uta+(qqa)+k
miniq	min+(i)+q
kitkutnik	ki+(tku)+t+nik
pilihaarnirmit	pi+(lihaar)+ni+rm+it
akirariik	aki+ra+(ri)+ik
naqittuq	na+(q)+ittuq
atauttikkuuqtut	a+ta+utti+(kku)+uq+tut
ikayuutauyukhanik	ik+ayu+(uta)+uyu+kha+nik
hiqanaakhiuti	hiqan+a+a+k+hi+(uti)
piannaqtuq	pi+anna+(qtu)+q
qiplaqhiqtuq	qi+p+la+(qhi)+qtuq
qanurinngittuq	qa+nur+(i)+nng+ittuq
hivulliqtikharnik	hivul+li+(qti)+khar+nik
ayuiqhautikharnik	ayu+i+(qha)+utikh+ar+nik
ujaranikpalliavut	ujara+(ni)+kpall+i+avut
umiaqpak	(umi)+aq+pak
uummati	uumm+a+(ti)
kimik	(ki)+mik
amaun	a+(ma)+un
halumajuq	ha+(lu)+majuq
hiitqumingajuq	hi+itqu+(mi)+nga+juq
aliktaa	a+(li)+kt+a+a
maligat	mal+i+(ga)+t
ajjiqijuq	ajj+(iq)+i+j+uq
qanuriliurutikhaniklu	qa+nur+(iliur)+utikh+a+nik+lu
hituliqtuq	hit+(u)+li+qtuq
titiraqhimajaat	ti+tiraq+hi+ma+(ja)+at
uuktuutikhat	uuk+tu+(uti)+khat
aqiamuk	aq+ia+(mu)+k
havaliqtut	hav+a+(liq)+tut
pihuktuq	pi+(hu)+kt+uq
allaqtaa	(alla)+qtaa
aullaaqtuq	a+ulla+(a)+qtuq
ihumagijaa	i+hum+(a)+gijaa
kipkaqtaa	kip+(k)+a+qtaa
qingalik	qi+(nga)+lik
ugjuk	(ugju)+k
ivjarun	ivj+ar+(u)+n
ayungitakharnik	ayu+(ngita)+khar+nik
kiliqtaa	ki+(li)+qtaa
ministaupluni	m+inista+(u)+plu+ni
nahaullik	na+(ha)+ullik
tikitqaaqtuq	t+iki+(tqa)+a+qtuq
uqummiaqtaa	u+qum+(mi)+a+qtaa
maqijuq	ma+q+(i)+j+uq
igalaaq	ig+(a)+laaq
tattit	ta+(tti)+t
ipikhaqtaa	ip+(ikha)+qtaa
kahaktaa	ka+(ha)+kt+a+a
ajjigijaa	(ajjig)+i+jaa
hivajaun	hiv+aj+(a)+un
huiqtuq	hu+(i)+qtuq
anuri	a+nur+(i)
ingilraatigut	i+ngi+(lra)+at+igut
naunaiyaiplutik	naun+a+iya+(i)+plu+tik
qaplunaaq	qa+pl+u+(naa)+q
tahamaniittuni	ta+ha+ma+ni+(ittu)+ni
nirijuq	ni+r+(i)+j+uq
naglingnaqtuq	na+(gli)+ngna+qtuq
aulajjuti	aula+(jj)+uti
nangmaktuq	na+(ngma)+kt+uq
hukkijaaqtuq	hukki+(ja)+a+qtuq
maliriq	mal+i+(ri)+q
pigliriaq	pi+(gli)+riaq
kaaffi	ka+a+(ffi)
uvalu	uva+(lu)
mikiliraq	mi+ki+l+(ir)+aq
uhiqtuq	(uhi)+qtuq
tuullik	tu+(ulli)+k
niuvrutikhaliyitkut	niuvr+(utikhal)+iyit+kut
akimajuq	aki+ma+(ju)+q
hatku	ha+(tku)
manniit	man+ni+(it)
qaluiraqtuq	qa+l+(u)+ira+qtuq
havagvikyuangani	hav+a+gv+(ikyua)+ng+a+ni
piannaqhutik	pi+anna+(q)+hu+tik
kukik	ku+(ki)+k
iglautigijaa	igl+a+(uti)+gijaa
polar bear cub	polar+( bear cub)
tajja	ta+(jja)
tikivikhaani	t+iki+(vi)+kha+a+ni
ulurianaqtuq	uluri+a+(na)+qtuq
naulaq	na+(ula)+q
gnkut	(gnkut)
anguniaqti	a+ng+un+i+(aqti)
ikimajuq	iki+(ma)+j+uq
aiviq	a+(ivi)+q
qanmaqtuq	qan+(ma)+qtuq
nakuunngittuq	nakuu+(nng)+ittuq
paan’ruqtuq	pa+an’r+(u)+qtuq
qaritauyakkurvik	qa+ritauya+(kku)+rvik
uqauhiit	uq+au+(hi)+it
auladjutiit	aula+dj+ut+(i)+it
pitquitjutainniklu	pi+(tqu)+itj+utain+nik+lu
hivayarluguluunniit	hivay+a+(rlugu)+lu+unni+it
amaruq	a+(ma)+r+uq
arvinilik	arvin+(ili)+k
pujurvik	pu+(ju)+rvik
haumimni	ha+(umi)+mn+i
takkumni	ta+(kku)+mn+i
uvinikliruvit	uv+(i)+nik+liru+vit
agiaqtuq	(agi)+a+qtuq
avikturviinnilu	av+ikt+u+(rvi)+in+nilu
aluutinnuaq	a+lu+(utinnu)+aq
umiktuq	(umi)+kt+uq
naunaiqhitauvaktuq	naun+a+iqhi+ta+(uva)+kt+uq
uviningni	uv+in+(i)+ngni
ikajuqtuq	ik+a+(ju)+qtuq
naliat	(nalia)+t
illaujaq	i+(lla)+uja+q
kijjak	ki+(jja)+k
nunaqaqtunut	nuna+(q)+aqtu+nut
qaniriktuq	qa+ni+(ri)+kt+uq
ui	u+(i)
tingittaitkun	ti+ngi+ttai+(tku)+n
uvinik	u+(vi)+nik
huliniaqpin	huli+ni+(aqpi)+n
qavvik	qa+(v)+vi+k
qilalugaq	qi+la+(lu)+gaq
kut	(k)+ut
naunaikpagait	naun+ai+(kpaga)+it
aulapkaivaktait	aula+pka+(ivak)+t+a+it
anarnat	a+na+(rna)+t
kigiaq	ki+(gi)+aq
pivagait	pi+(vaga)+it
kia	ki+(a)
imunrit	im+(unri)+t
hapkuat	ha+p+(ku)+at
uipkuaq	u+(ipku)+aq
mihuktuq	mi+(hu)+kt+uq
ilihautijaa	ili+ha+(uti)+jaa
algaaq	alg+(a)+aq
imaiqtaa	ima+(i)+qtaa
hunagaijaijuq	hu+na+(gaija)+i+j+uq
nmto	n+(mto)
qanniq	qa+(n)+niq
qanuritpit	qa+nur+(itpi)+t
aanaakhiiq	a+(anaakhii)+q
allaruti	a+(llar)+uti
kuniktuq	(kuni)+kt+uq
naunaitkutait	na+una+it+(ku)+t+a+it
atuqtauhimaaqtukhaq	at+uqtau+(hima)+aqtu+khaq
irnia	irn+i+(a)
hivuliqtiuvakhimayuq	hivul+iqt+(iu)+v+akhima+yuq
tiirluk	ti+(ir)+lu+k
ablaangajuq	a+b+(laa)+nga+juq
ihuittuq	i+hu+(i)+tt+uq
ikayuktiuyuq	ik+ayu+(kti)+u+yuq
in’ngutaq	i+(n’ng)+ut+aq
inuarullik	inu+(ar)+ullik
havaanut	hav+a+(an)+ut
takuttailijuq	taku+(ttail)+i+j+uq
puiniq	pu+(i)+niq
tarjuliaqtuq	t+ar+j+(uli)+a+qtuq
ayuitamingnik	ayu+(ita)+mi+ng+nik
tikinnatin	t+iki+(nna)+tin
ahijjijuq	a+hi+(jj)+i+j+uq
takkurni	ta+(kku)+r+ni
ijaruvak	(ijaru)+vak
kivgaluk	kiv+(ga)+lu+k
maamauti	(maama)+uti
tingmiakkuuqtuq	tingmi+(akku)+u+qtuq
uhingajuq	(uhi)+nga+juq
ubluqtujuq	ub+lu+(qtu)+j+uq
atan’ngujuq	a+t+an+(’ng)+u+juq
kuplu	k+(uplu)
mikilirarmiaq	mi+ki+l+(irarmi)+aq
qalutaujaq	qa+l+(uta)+uja+q
ilumuuqtuq	ilu+(mu)+u+qtuq
ugjulik	u+(gju)+lik
tuktuujaq	tu+(ktu)+uja+q
ilaanilu	i+la+(a)+nilu
qajaqtuqtuq	qa+(j)+aqtu+qtuq
puvitqurnaqtuq	p+uv+(itqu)+rn+a+qtuq
agluqtuq	a+(glu)+qtuq
buildingnunavut	(build)+ingn+un+avut
alruyaliqititigut	a+lr+(uyaliqi)+tit+igut
sikiituuq	si+ki+(ituu)+q
attiaq	a+(tti)+aq
attiqtaa	a+(tti)+qtaa
ivalu	(ivalu)
qin’ngut	qin+’ng+(u)+t
quviahunngittuq	quviahu+(nng)+ittuq
piyaangani	pi+(yaa)+ng+a+ni
titirarvikhaq	titir+a+(rvi)+khaq
amigairyumiqtitiniaqhimayut	amig+a+(iryumiqtitiniaq)+hima+yut
nivinngarvik	ni+(vinng)+arvik
pinnirijaa	pi+(nni)+rijaa
hivulirijaa	hiv+(uli)+rijaa
ihuma	i+hu+(ma)
qatanngutigiinik	qa+ta+(nngutigi)+i+nik
aniu	a+ni+(u)
niuviqpaktup	ni+uv+i+(qpa)+k+t+up
attirniik	att+ir+(ni)+ik
imuniq	(imu)+niq
uumani	(uuma)+ni
laisinik	lais+(i)+nik
amigailuhiluuniit	amig+a+(i)+lu+hi+lu+uniit
quaqhalaarut	qu+aq+ha+la+(ar)+ut
humunngauvin	hum+unng+(auvi)+n
pauq	(pa)+uq
akhaarniq	ak+ha+(a)+r+niq
ayuikhautihimaaqtukharnik	ayu+(ikha)+uti+hima+aqtu+khar+nik
titiraqtaa	ti+(tir)+a+qtaa
qaujihaidjutit	q+auj+i+ha+(idjut)+it
pualuk	pu+al+(u)+k
taki	t+ak+(i)
ilainnunngaqtaa	i+la+(innunng)+a+qtaa
anitaa	a+(ni)+taa
naunaiyaidjutikhanut	naun+a+iya+(idjut)+ik+ha+nut
havaqutingmik	hav+a+(quting)+mik
haamlatkunnut	ha+(amlat)+k+un+nut
iijjiraaluk	iijjir+(aa)+lu+k
ausuittuq	a+(usu)+ittuq
nakuukpiaktuq	na+ku+ukp+iak+t+(u)+q
pigiaqaqtunik	pi+(giaq)+aqtu+nik
havaktit	hav+akt+(i)+t
pamialluk	pa+mi+(al)+lu+k
kukiktaa	ku+(ki)+kt+a+a
uqumaittuq	u+qum+(a)+ittuq
hivumut	hiv+(u)+mut
mihiktuq	mi+(hi)+kt+uq
pinniqtuq	pi+(nni)+qtuq
ani	a+(ni)
ilaptingnullu	i+la+(pting)+n+ullu
titiqtuun	titiq+(tu)+un
mahak	ma+(ha)+k
ujaraliaq	ujara+(li)+aq
nunamingni	nuna+(mi)+ngni
ikumajuq	iku+(ma)+j+uq
uuktuutikhangit	uuk+tu+(utikha)+ngit
atuqpakhimajavut	atuq+pa+k+(hima)+j+avut
aularaanginaqtumik	aula+(raangin)+aqtu+mik
nunagiyauyuni	nu+(na)+giyauyu+ni
nunaqatigiit	nuna+(qatigi)+it
uqautjiyiit	(uqautjiy)+iit
munaqtiuyut	mu+na+(qti)+uyut
nutqaqtuq	nu+(tqa)+qtuq
uqauhiq	uqa+(uhi)+q
line	(line)
tupakhaqtaa	tu+p+(akha)+qtaa
hukhamut	hu+(kha)+mut
paniqtuq	pa+(ni)+qtuq
aanniaruiqtun	a+anni+(aruiqt)+un
maligaq	mal+(i)+gaq
havgun	ha+(vg)+un
tupittuq	tu+(p)+ittuq
kavamatkuanni	ka+(vama)+t+ku+anni
nuliangiqtuq	nul+i+(angi)+qtuq
titiraqhimayuq	titir+a+(q)+hima+yuq
nikpaqtuq	ni+(kp)+a+qtuq
aakhamingnik	a+(akha)+mi+ng+nik
avatquhimayumik	av+at+(qu)+hima+yu+mik
ikajurumajait	ik+a+(ju)+ruma+jait
pituutaq	pi+(tu)+ut+aq
uplukittuq	u+pl+(u)+k+ittuq
taliqpingmuuqtuq	t+al+(iqpi)+ngmu+u+qtuq
qajangnaitkutikhanut	qa+j+ang+na+it+(kut)+ik+ha+nut
hukkinnaaq	hukki+(nna)+aq
uttuk	(utt)+uk
piksa	pi+(ksa)
aqagumunngaqpan	aqagum+unng+aq+pa+(n)
naunaitunik	na+una+it+(u)+nik
angmagiaq	a+(ngma)+gi+aq
humiutauvin	hu+mi+(utauvi)+n
annirutijaujuq	anniru+(tija)+u+juq
killaijaqtaa	kill+(aija)+qtaa
qilaaq	qi+la+(a)+q
tatattuq	ta+(ta)+tt+uq
hamunga	ha+(mu)+ng+a
ikajuq	ik+(a)+j+uq
inuuhuktulirijinilu	inu+uhuktu+(lir)+iji+nilu
quviahuujuq	quviahu+(u)+j+uq
aadjikutaliurhimanirmut	aadji+ku+ta+liur+(hima)+ni+rm+ut
aulaniqaqtunik	aula+(n)+iq+aqtu+nik
piaraq	pi+(a)+raq
havangnatik	hav+a+(ngna)+tik
quq	(q)+uq
ilannariik	i+la+(nnari)+ik
iqutujuq	i+qu+(tu)+j+uq
maligaliqiyunik	mal+ig+aliq+(i)+yu+nik
ivajuq	i+(va)+j+uq
iijjilaqijuq	i+(ijjilaq)+i+j+uq
akikittuqtaarijaa	aki+(k)+ittuq+taa+rijaa
iritaqtuq	i+(rit)+a+qtuq
amiraq	a+(mir)+aq
atiq	a+(ti)+q
haililiqqatalu	ha+(ili)+liq+qa+ta+lu
igliq	i+(gli)+q
atnaguyauyunut	at+(naguya)+uyu+nut
manikhavingit	man+ik+ha+(v)+i+ngit
illaijuti	il+lai+j+(uti)
atiliugluhi	at+ili+(uglu)+hi
ilihimayakhainiklu	ili+(hima)+ya+khai+nik+lu
maniktaqvikharnik	man+ik+ta+(qvikha)+r+nik
annivik	a+(nni)+vi+k
anujijuq	an+(uji)+j+uq
nipitqaqtaun	ni+pit+(qaqta)+un
utuqqaq	ut+uq+(q)+aq
ihumagijauttiarniq	i+hum+(agijautti)+ar+niq
hiipangnittuq	hi+ip+a+(ngni)+tt+uq
amaamaupluni	a+(maama)+up+lu+ni
maniliqutinut	man+ili+q+(uti)+nut
kikturiilitaq	ki+k+tu+ri+(ili)+taq
mitiinnaq	mi+(ti)+in+naq
pinahuarumayatik	pi+nahu+ar+u+(mayati)+k
unipkaaqtuq	un+(ipka)+a+qtuq
anaqtauti	an+aq+ta+(uti)
arnaqhiuti	arna+(qhi)+uti
kavamaliqiiyinut	k+ava+mal+(iqiiy)+in+ut
pilraak	pi+(lraa)+k
havaqatigiikhutik	hav+a+(qatigi)+ikhu+tik
iviangiq	ivi+angi+(q)
quijuq	qu+(i)+j+uq
hivullirmik	hivul+li+(r)+mik
kakkiijaut	ka+(kkiija)+ut
kitkut	k+(i)+tkut
titiraq	titir+a+(q)
uluagullik	u+lu+(ag)+ullik
amaamaun	a+(maama)+un
ilihimajuq	i+(li)+hi+majuq
kitulliqaak	ki+(tul)+liq+a+ak
qiuktaqtuq	qi+(u)+kta+qtuq
iliphi	ili+(phi)
tuffiuqtuq	tu+(ffiu)+qtuq
pivikhaitanutlu	pivikh+a+(ita)+nut+lu
uqauhingita	uq+au+(hi)+ngit+a
pangnirtung	(pa)+ng+nir+tu+ng
titiraakhaun	titir+a+(akha)+un
qaniaq	qa+ni+(a)+q
havakvingmi	hav+ak+(vi)+ng+mi
qarjuk	(q)+ar+ju+k
aptuniqtujuq	aptu+ni+(qtu)+j+uq
tunutaa	tu+n+(u)+taa
ulrujaaqtuq	u+(lru)+jaa+qtuq
aniqhaaqtariami	a+niq+ha+(aqtariami)
hilahiun	hila+(hi)+un
tigliktaa	tig+(li)+kt+a+a
hivuliqti	hivul+iqt+(i)
ukiunganik	ukiung+(a)+nik
allaijaqtaa	a+ll+(aija)+qtaa
utimuktuqtuq	ut+i+mu+(ktu)+qtuq
nunaryuani	nuna+(ryua)+ni
ataniqarvingmi	a+t+an+(iqa)+rvi+ngmi
havakniaqtangit	hav+ak+ni+(aqta)+ngit
hikuun	h+iku+(u)+n
inuinarnik	inu+(inar)+nik
naittumik	na+(ittu)+mik
havaktiinik	hav+akt+(i)+i+nik
aullaqtinnanuk	a+ull+aq+(tinna)+nuk
imiqtuq	i+(mi)+qtuq
havakvingitlu	hav+ak+(vi)+ngit+lu
ataani	a+(ta)+ani
aquuti	(aqu)+uti
atuqtaghapfingnikakiitut	at+uqt+(a)+gha+pfing+nik+aki+it+ut
apiqhuqtuq	ap+(iqh)+u+qtuq
ingittuq	(i)+ng+ittuq
hungajaaqtuq	hu+(nga)+jaa+qtuq
najjak	na+(jja)+k
naunaiyautainnik	naun+a+iya+(uta)+in+nik
nipitiruti	ni+pit+(ir)+uti
amihut	a+mi+(hu)+t
iqhijuq	(iqh)+i+j+uq
nunaptingni	nuna+(pting)+ni
tuniuqhaivaktut	tu+ni+(uqhai)+vak+tut
nikhiktaa	ni+(khi)+kt+a+a
kutni	ku+(t)+ni
maliruagakhallu	mal+i+(ruagakha)+llu
munarilugitlu	mu+na+(ri)+lu+git+lu
ulapqinikkut	ul+apq+(i)+nik+kut
putukkuk	pu+tu+(kku)+k
avalu	ava+(lu)
hivayautaanun	hivay+a+(utaa)+n+un
uplu	(uplu)
hituaqtuq	hi+(tu)+a+qtuq
ca	(ca)
ivjannguhuktuq	ivj+(annguhu)+kt+uq
tatatpiaqtaa	tat+at+(pi)+a+qtaa
qaniq	qan+(i)+q
qitiqqautijuq	q+iti+(qqa)+uti+juq
irnikhaq	irn+i+(kha)+q
ikayukhimaanginaqhutiklu	ikayukhi+ma+angi+(naq)+hu+tik+lu
ukkuaqtuq	u+(kku)+a+qtuq
nalunaqtunik	na+lu+(n)+aqtu+nik
nimuuniaqtuq	ni+mu+u+ni+(a)+qtuq
upalungaiyailiqiyunik	u+pa+(lungaiya)+iliq+iy+u+nik
titirarvikhat	titir+a+(rvi)+khat
qanilrukkun	qa+ni+(lrukk)+un
piujaqtuq	pi+(uj)+a+qtuq
qimiriaq	qi+(mi)+riaq
ingnirvik	i+(ngni)+rvik
haqalikitaaq	ha+(qalikita)+aq
tukiliurutit	t+uk+(iliur)+uti+t
kapuhiqujaulimaittut	ka+pu+(hiqujau)+lima+it+tut
hanaqidjutigiyauhimayut	ha+n+aq+idjut+(igiyau)+hima+yut
kipataa	ki+(pa)+taa
havangnahi	hav+ang+(na)+hi
takimut	ta+(ki)+mut
auladjutivikhainnut	aula+dj+ut+(ivi)+kha+in+nut
talvuunaluunnit	ta+lv+(uuna)+lu+unni+t
nalvaaqtaa	(nalva)+a+qtaa
ilaanittauq	i+la+(an)+it+ta+uq
uitajuq	u+(ita)+j+uq
ikijaa	ik+(i)+jaa
ihuaqhautit	i+hu+(aqha)+uti+t
mitquiqhijuq	mitqu+(iqh)+i+j+uq
natquq	na+(tqu)+q
qaqqulaannguqtuq	qa+q+qu+(laanng)+u+qtuq
aanniarutingnik	a+anni+a+(r)+ut+ingn+ik
havaktiuyut	hav+akt+(i)+uyut
nutaqqiuqtaa	n+utaqq+(iu)+qtaa
pinahuarutikhainik	pi+nahu+ar+u+(ti)+khai+nik
quanaqtuq	qu+(an)+a+qtuq
niqiliuqtuq	ni+q+(ili)+u+qtuq
ivjaqut	ivj+(aq)+ut
nanminiqaqtullu	na+nmin+(iqaq)+t+ullu
agjaqtaa	a+(gja)+qtaa
kuttuq	(ku)+tt+uq
nukatukkaaq	(nukatu)+kkaaq
ilituqhainahuarniq	ilit+uqhai+(nahuar)+niq
munaqtiit	mu+na+(qti)+it
nahaq	na+(ha)+q
qaritauyami	qa+ritauya+(mi)
tunin’nguitkutikhaq	tu+ni+(n’ng)+uitk+uti+khaq
unniutjutillu	(un)+niutjuti+llu
hinaa	hi+na+(a)
mitqut	mitqu+(t)
qituhungnaqtuq	qi+tu+(hungn)+a+qtuq
tamatkiqtaa	t+ama+(tki)+qtaa
uqaqvigilugu	u+qa+q+vi+(gi)+lu+gu
tunmiraq	tu+n+(mir)+aq
uvaptignik	uva+(p)+tig+nik
igluqpait	igluqpa+(i)+t
havaaqharnik	hav+a+(aqha)+r+nik
amaamaktuq	a+(maama)+kt+uq
arnaaqutaq	arna+(aq)+ut+aq
ikayuutauhunguyuq	ik+ayu+(utauhung)+u+yuq
tapkuninga	ta+p+ku+(ni)+ng+a
ihuaqhihimani	i+hu+(aqhi)+hima+ni
pinahuarutikhat	pinahu+a+(r)+utikh+at
tauplutik	ta+(uplu)+tik
angijuugaluit	angi+(juuga)+lu+it
atqaqtuq	a+(tqa)+qtuq
nunaniglu	nuna+(ni)+g+lu
qituhuktuq	qi+(tuhu)+kt+uq
tigvaqtuq	tig+(v)+a+qtuq
haunittiaq	haunitti+(a)+q
ukiakhaq	uk+i+(akha)+q
ivjurnauti	ivj+u+(rna)+uti
nauk taimna	na+(uk )+tai+mna
havaktauyukhani	hav+akt+(auyukh)+ani
piliuriami	p+ili+u+(ri)+a+mi
uunaqtuq	(uuna)+qtuq
anu	an+(u)
qaritauyaliqidjutit	qa+r+it+auyal+iq+(idjut)+it
tail of fish	ta+(il of f)+is+h
atqin	a+(tqi)+n
kuvjiqtuq	ku+vj+(i)+qtuq
havaktip	hav+akt+(ip)
im’ngun	im+(’ng)+un
hiti	hit+(i)
kapuut	ka+pu+(u)+t
tuniyauyut	tu+(ni)+y+auyut
turaaqhimayuq	tu+(raaq)+hima+yuq
ungahiaqtuq	ung+a+(hi)+a+qtuq
uqauhialluunniit	uqa+(uhia)+llu+unni+it
qin’ngaut	qin+’ng+(a)+ut
havagiikhimayuq	hav+a+(giikhima)+yuq
numiktiriji	(numiktir)+ij+i
titiqiqiyiingit	titiq+iq+(iyi)+i+ngit
hilalliq	hila+(lli)+q
qilaut	qi+(la)+ut
atungaujaq	at+u+(nga)+uja+q
hadja	ha+(dja)
mikijuq	miki+(ju)+q
amiijaijuq	a+mi+(ija)+i+j+uq
amiritjutinik	a+mir+(itjut)+i+nik
pitikhaqtuq	pi+ti+k+(ha)+qtuq
nutaraq	n+uta+(r)+aq
hiitquaqtuq	hi+itqu+(a)+qtuq
talittuq	ta+(l)+ittuq
havingma	ha+vi+(ngma)
angilrarvik	angil+ra+(rvi)+k
uilik	u+(ili)+k
paan’nguliaq	pa+an’ng+(uli)+aq
tiiliurun	ti+(iliur)+un
ulapqiyut	ul+apq+(i)+yut
utigyakniaguvin	utigya+k+ni+(a)+guvin
nguyaita	(nguya)+ita
aiq	a+(i)+q
havakviinnut	hav+ak+(vi)+in+nut
kanna	ka+(nna)
kaagliqpunga	ka+a+(gli)+q+punga
kigutaiqtuq	kigut+(a)+i+qtuq
havaktakhainullu	hav+akt+(akha)+in+ullu
pimmariktuq	pi+(mmari)+kt+uq
nirij	niri+(j)
nunagiyainut	nuna+(giyain)+ut
kasiliinut	ka+s+ili+(i)+nut
pivikhainnikni	pivikh+a+(in)+nik+ni
tipjariktuq	(tipjari)+kt+uq
ingniqutiliqitigut	ing+niq+(uti)+liq+it+igut
uhiarun	(uhiar)+un
tununngani	tu+n+(un)+ng+a+ni
tungungajuq	tu+(ngu)+nga+juq
igajuq	i+(ga)+j+uq
qapalaqijuq	qap+(alaqi)+j+uq
qaphaktaqtuq	qa+(pha)+kta+qtuq
ikayuqlugit	ik+ayu+(q)+lu+git
mi	(mi)
makpiraangani	m+ak+(piraang)+ani
titirakhaq	titir+a+(kh)+aq
uviluq	u+(vilu)+q
situasaaluti	si+tu+(asaalu)+ti
nutaanut	n+uta+(a)+nut
ikuutaqtuq	iku+(ut)+a+qtuq
naharaq	na+(ha)+raq
aujuq	a+(u)+j+uq
hiulluktuq	hi+(ullu)+kt+uq
tahin’ngajuq	ta+hi+(n’)+nga+juq
tuffijuq	tu+(ffi)+j+uq
aittuqtuq	a+(ittu)+qtuq
akituyunut	aki+(t)+uyu+nut
atan	a+(ta)+n
gps	(gps)
taliqpiani	t+al+(iqpi)+ani
aplaangajuq	ap+(laa)+nga+juq
kavamatkunnillu	ka+(vama)+tk+unni+llu
ingmiqtuq	i+(ngmi)+qtuq
com	co+(m)
taaqhivalirvia	ta+aq+hiv+a+(li)+rvi+a
havilqhiaq	hav+il+(qhi)+aq
arnalluaq	a+(rna)+llu+aq
algiqhiijuq	alg+(iqhii)+j+uq
nunamin	nuna+(min)
ahiruijuq	a+hi+(ru)+i+j+uq
queen	qu+(ee)+n
hold	(hold)
igluqpainut	igluqpa+(i)+nut
ilaruhirijaa	i+la+(ruhi)+rijaa
ohokak	(ohoka)+k
ingilirutikharnik	ing+(ili)+r+utikh+ar+nik
taimailiuqtuq	t+a+i+ma+(ili)+u+qtuq
piutinggit	pi+(uti)+ng+git
tangmaaqtuq	t+ang+ma+(a)+qtuq
tumi	tu+(mi)
akimaittuq	aki+ma+(i)+tt+uq
tunivaktait	tu+n+(ivak)+t+a+it
kangiqhijjut	kang+iqhi+(jj)+ut
avittuq	(avi)+tt+uq
patiq	pa+(ti)+q
takhijaa	t+ak+(hi)+jaa
ilihariaqpaalliviat	ili+ha+(riaqpa)+allivi+at
atuqquyauhimayuq	atuq+qu+(yau)+hima+yuq
naunaiyaivakhutiklu	naun+a+iya+(ivak)+hu+tik+lu
tiriaq	(ti)+riaq
kaaktuq	ka+(a)+kt+uq
papik	pa+(pik)
alianai	al+ia+na+(i)
puptati	pu+(pta)+ti
munariyukhallu	mu+na+(ri)+yukh+a+llu
kablaq	ka+(bla)+q
majurautaq	majuraut+(a)+q
ahu	a+(hu)
ilihariaqpaallivianni	ili+ha+(riaqpa)+allivi+anni
qayangnairutiqarlutin	qa+(yangnai)+ruti+q+ar+lutin
atigi	a+(ti)+gi
itingmiktaa	(iti)+ng+mik+taa
kigutit	kigut+(it)
kamisinami	ka+mi+si+(n)+a+mi
auktirut	auk+(tir)+ut
pivikhaqautikkut	pi+(vikhaqauti)+kkut
katittait	ka+(tit)+t+a+it
nanguttijuq	nang+(utti)+j+uq
upalungaiyautit	u+pa+(lungaiya)+uti+t
aulapkaidjutikhanik	aula+pka+(i)+djut+ikha+nik
uqautijaa	uqa+(uti)+jaa
nulialik	nul+i+(a)+lik
pikijuq	pi+(k)+i+j+uq
iluviik	ilu+v+(i)+ik
pilaarutait	pi+(laaru)+t+a+it
patuqutaujuq	pa+(tuquta)+u+juq
maniliukhimaangitun	ma+ni+(liuk)+hima+a+ngit+un
iqiahuktuq	(iqiahu)+kt+uq
piritaa	pi+(ri)+taa
aullatjutikhatigut	a+ulla+(tj)+utikh+a+t+igut
qulvik	qu+l+(vi)+k
tuhaadjutikharniklu	tu+ha+(adj)+utikh+ar+nik+lu
hannaiqtuq	ha+(nna)+i+qtuq
aqamaaktuq	aq+ama+(a)+kt+uq
maliktakhaniklu	mal+i+(ktakha)+nik+lu
havakpaktait	hav+a+(kpak)+t+a+it
aullaqhimakhaaqtuq	a+ull+aq+(hima)+kha+a+qtuq
hivutuniqaqtuq	hiv+ut+(uniq)+a+qtuq
niqiliqivik	ni+qi+(liq)+iv+ik
uvattiaq	uv+attia+(q)
ukuninga	u+(kuni)+ng+a
uriuqtuq	u+(ri)+u+qtuq
humit	hu+(m)+it
auttuq	a+u+(ttu)+q
atira	at+(ira)
iqaluktuuttiami	iqa+luk+(tuutti)+a+mi
nuna	nu+(na)
aqqaluakhaq	a+(qqalua)+khaq
qalagjuarnirmik	qala+gjuarn+(irmi)+k
akhaluutikkuuqtuq	ak+ha+(luutikku)+u+qtuq
hanningajulik	h+anni+ng+(aju)+lik
kinauvit	ki+na+u+(vi)+t
malikniinnik	mal+i+(k)+ni+in+nik
pigliqtuq	pi+(gli)+qtuq
humiitpa	hu+mi+(itpa)
hitammiut	hit+am+(mi)+ut
qilirniqtaa	q+ili+rn+(i)+qtaa
taamnataamna	ta+(a)+mna+taa+mna
hivunniriiqtuq	hivun+niri+(i)+qtuq
sikiiraqtuq	si+ki+(ir)+a+qtuq
ilitturidjutikhat	ili+t+tur+(idj)+utikh+at
ilitturiplutik	ili+t+tur+(i)+plu+tik
havaqatigititlugit	hav+a+(qatigi)+t+it+lu+git
malik	mal+i+(k)
ukium	uk+i+(um)
aullapkaidjutikhangit	a+ulla+pka+(idj)+utikh+a+ngit
qanuq akituvaaa	qa+(nuq )+akitu+v+a+a+a
hanirarmik	h+an+(irarmi)+k
mikigaq	mi+(ki)+gaq
tikitinnanga	t+iki+(tinna)+nga
agyaktunut	(agya)+kt+unut
angirutaani	angi+(r)+u+taa+ni
havangtinnanuk	hav+ang+(tinna)+nuk
aqubliqtuq	aq+ub+(li)+qtuq
hikuarniq	h+iku+(a)+r+niq
uluaqtuun	u+lu+(aqtu)+un
unaguqtuq	u+na+(gu)+qtuq
ariujaa	(ariu)+jaa
aallannguqtuq	aall+a+(nng)+u+qtuq
tatattaa	tat+(at)+taa
puvla	p+uv+(la)
nanminirijaujunut	na+nmin+(irijau)+ju+nut
atuqtitaa	at+uqt+(i)+taa
najuqtaa	na+(ju)+qtaa
anikhaq	an+(i)+khaq
qakugulu	qa+ku+(gu)+lu
aktikkutariik	a+(kti)+kkut+ar+iik
piyaangini	pi+(ya)+angi+ni
talrit	ta+(lr)+it
inuaqtaa	inu+(a)+qtaa
aglu	(a)+g+lu
mittarvik	m+(itta)+rvik
alurnaq	a+lu+(rna)+q
hiqulaaq	hi+qu+(la)+aq
ihuuriktuq	i+hu+(uri)+kt+uq
hiniktuq	hi+n+(i)+kt+uq
pilaut	pi+(la)+ut
qiniqhiayiit	qin+iqhi+a+(yii)+t
ilarahuktuq	i+la+(rahu)+kt+uq
angaajjuvik	ang+aajj+(u)+vi+k
laisikhnik	lais+(ikh)+nik
nunamun	nuna+(m)+un
igluaqtuq	i+glu+(a)+qtuq
iviangiilitaq	ivi+angi+(ili)+taq
tamangnik	t+ama+(ng)+nik
ngit	ng+(it)
hingaijuq	hi+n+(ga)+i+j+uq
ingilrutikharnik	i+ngi+(lr)+utikh+ar+nik
taiguaqtaa	ta+(igu)+a+qtaa
maniliqinikkut	man+(i)+liq+inikk+ut
immiqijuq	im+mi+(q)+i+j+uq
navikhimajuq	na+v+(ik)+hi+majuq
kaivjaqtaa	ka+i+(vja)+qtaa
iqujuq	iq+(u)+j+uq
aullapkaitjutinginni	a+ulla+pka+(itjut)+in+gin+ni
tunihilatpata	tu+ni+(hilatpata)
aullapkaidjutikhainik	a+ulla+pka+(idj)+utikh+a+i+nik
kapuutikhat	ka+pu+(utikha)+t
aiktautituq	a+(iktautit)+uq
paniqhiqtuq	pa+n+iqhi+(qtu)+q
angujaa	ang+(u)+jaa
ikajuutikhaqqut	ikajuut+(i)+khaq+q+ut
nuijjiijuq	nu+(ijji)+i+j+uq
arja	arj+(a)
aturutiniklu	a+tur+(uti)+nik+lu
aullarnata	a+ulla+(rna)+ta
hurjuktuq	hu+(rju)+kt+uq
niuviqpaktut	ni+uv+i+(qpa)+kt+ut
titiraut	titir+a+(u)+t
init	(in)+it
inungnin	inu+(ngni)+n
atuqhugit	at+u+(q)+hu+git
kannguhuktuq	k+(annguhu)+kt+uq
natirnaq	na+(ti)+rnaq
tamatkingniit	t+ama+(tki)+ngni+it
ilihimanngittuq	ili+(hima)+nng+ittuq
kauttuaq	ka+uttu+(a)+q
ubluriaq)star	ub+lu+(ri)+aq+)st+ar
ukuaq	u+(ku)+aq
ikayuutikharnik	ik+ayu+(uti)+khar+nik
ikayuutauyut	ik+ayu+(uta)+uyut
havangnani	hav+ang+(na)+ni
ilukittuq	ilu+(k)+ittuq
irninilu	irn+i+(ni)+lu
puiguqtuq	pu+(igu)+qtuq
minguktaa	mi+(ngu)+kt+a+a
kavamanga	ka+(vama)+ng+a
apquti	ap+qu+(ti)
iglunik	(iglu)+nik
makittuq	(ma)+k+ittuq
malruraaqtuq	malru+(ra)+a+qtuq
havagutikhanik	hav+a+(g)+utikh+a+nik
nanminiriyauyunik	na+nmin+(iriya)+uyu+nik
qipik	qi+(pi)+k
uplumittauq	u+pl+(um)+it+ta+uq
avgun	a+(vg)+un
kiinaa	ki+ina+(a)
qaluraun	qa+lura+(un)
haqpik	haq+(pi)+k
algaak	alg+(aak)
apluqtuq	ap+(lu)+qtuq
hiquriaqtuq	hi+qu+(ri)+a+qtuq
agjautik	a+(gja)+uti+k
in’ngaqtuq	i+(n’ng)+a+qtuq
pauqtuq	(pa)+u+qtuq
ikpakhaani	ikp+(a)+kha+a+ni
unnaqtutit	u+(nnaqt)+uti+t
atuuti	a+(tuuti)
amaulik	ama+(u)+lik
algu	alg+(u)
haulluqtuq	ha+(ullu)+qtuq
apittiuvik	a+pit+(tiu)+vi+k
em	(em)
ikayuutit	ik+ayu+(uti)+t
qanuktut	qan+(ukt)+ut
takujuq	ta+(ku)+j+uq
ihivriuqhiluni	ihivr+i+(uqhi)+lu+ni
qunmut	qu+n+mu+(t)
avguqtauttiaqhuni	av+guqta+(utti)+aqhu+ni
ilauniaqtuq	il+au+(ni)+a+qtuq
qungujuktuq	qu+ng+u+(ju)+kt+uq
nangiarnaqtuq	na+ngi+(a)+rn+a+qtuq
qiajuq	qi+(a)+j+uq
aittuuhiaqtuq	a+ittu+(uhi)+a+qtuq
kaiptaq	ka+i+(pta)+q
pitiktaa	pi+(ti)+kt+a+a
avittuk	a+v+(ittu)+k
inmikkuukpalliadjutikhanginik	in+mikk+(uukpalliadj)+utikh+angi+nik
niu	ni+(u)
nuliaq	nu+(li)+aq
hikuliaq	h+iku+(li)+aq
katuktuq	ka+(tu)+kt+uq
maamaktuq	(maama)+kt+uq
ilaaqtuqtaa	i+la+(aqtu)+qtaa
naarliuqtuq	naa+(rli)+u+qtuq
puviqtaq	p+uv+(iq)+taq
arvinilitpingahuat	arvin+ilit+pi+(ngahu)+at
nuungutirniaq	nu+u+nguti+(rni)+aq
ajuaq	(aju)+aq
pimattiarniq	pi+(mattiar)+niq
marlungajuq	ma+(rlu)+nga+juq
atugakhat	at+u+(ga)+khat
kuapikkat	ku+a+pi+(kk)+at
aallami	aall+a+(mi)
aqpajuaqtuq	aqpa+(ju)+a+qtuq
uqautiniklu	uq+au+(ti)+nik+lu
aallatqiiktuk	aall+a+(tqi)+iktuk
pijumanngittuq	p+ij+u+(ma)+nng+ittuq
kiliqtuq	(ki)+li+qtuq
alrujiqiji	alruj+i+(qi)+ji
munagiyaingit	munag+i+(ya)+i+ngit
qiniqhiattiaruvit	qin+iqhi+a+(tti)+ar+u+vit
hiqquqtiun	hiqquqti+(u)+n
kavamatuqatkut	ka+(vama)+tu+qa+tkut
kavamatkut	ka+(vama)+tkut
natiruvilaqutijuq	natir+uv+(ilaq)+uti+juq
havagviuyuq	hav+a+gv+(i)+u+yuq
imaruqtuq	im+(ar)+u+qtuq
qalalaqijuq	qa+l+(alaqi)+j+uq
ikajuutigijauniarumik	ikajuut+(i)+gijauni+ar+u+mik
ilitarnaqtuq	ili+(ta)+rn+a+qtuq
angijunik	angi+(ju)+nik
angmaqtaa	a+(ngma)+qtaa
kakiniq	ka+(ki)+niq
titqaut	ti+(tqa)+ut
aupadjalaqiluni	au+padj+(alaqi)+lu+ni
algirnilaqijuq	alg+(irnilaq)+i+j+uq
pinnguu	pi+(nngu)+u
ulrujuq	u+(lru)+j+uq
ihiq	i+(hi)+q
pivikhat	pi+(vi)+khat
aqhaaqtaa	aq+ha+(a)+qtaa
hanmipluni	h+an+(mi)+plu+ni
mirhurniq	mir+(hu)+r+niq
ingniqutilik	ing+niq+(uti)+lik
ipiqtuq	ip+(i)+qtuq
kiilliq	ki+il+(liq)
kiluuttaq	(kiluutt)+aq
alruyaqtuqtunik	a+lr+(uya)+qtuq+tu+nik
kiahirutilik	ki+ahir+(uti)+lik
agiraqtuq	a+(g)+ira+qtuq
aqpaliutijuq	aqpa+(li)+uti+juq
qarritijaa	qa+(rriti)+jaa
qijualiuqtuq	qi+(jualiu)+qtuq
angujuq	a+(ngu)+j+uq
qiniqtaa	qi+(ni)+qtaa
qijuk	qi+(ju)+k
pinahugijaa	pi+(nahu)+gijaa
aujaq	(a)+uja+q
qanuritpa	qa+nur+(itpa)
kapuqhirvikhaat	ka+puq+hirv+(ikha)+at
qipikhimajuq	qi+(pik)+hi+majuq
nunaryuanut	nuna+(ryua)+nut
tahapkuatlu	ta+ha+p+(kuatlu)
tamaita	t+ama+(ita)
hanmitijuk	h+an+(mitiju)+k
uukturiangani	uuk+tu+(ria)+ng+a+ni
qin’ngutik	qin+’ng+(uti)+k
qanilrukkut	qa+ni+(lru)+kkut
minittailijaa	mi+ni+(ttail)+i+jaa
ulapqipkainikkullu	ul+apq+i+pka+(i)+nik+kul+lu
uqaqtuq	uqa+(qtu)+q
imiq	i+(mi)+q
kipkariktuq	kip+(kari)+kt+uq
kihiani	ki+(hi)+ani
inuuqatigijaa	inu+(uqati)+gijaa
upalungaijautikhat	up+a+lu+ng+(aija)+utikh+at
havaaqhaq	hav+a+(aqha)+q
naunaitkutit	na+una+it+(k)+uti+t
mikigijait	miki+(gija)+it
hikun’ngiqtuq	h+iku+(n’ng)+i+qtuq
ilijaa	(ili)+jaa
imaaqtuq	i+(ma)+a+qtuq
aulahimaarniaqtun	aula+(himaarni)+aqtun
ikayuutikhat	ik+ayu+(uti)+khat
upalungguyaiplutiklu	up+a+lu+ng+(guyai)+p+lutik+lu
uqauhilirijillu	uq+au+(hilir)+iji+llu
nunallaani	nuna+(lla)+ani
tunuani	tu+n+(u)+ani
anguuti	ang+u+(uti)
nalujuq	na+(lu)+j+uq
ihumaittuq	i+hum+(a)+ittuq
qaffinikukiuqaqqa	qa+(ffiniku)+kiuqaq+qa
hilarluk	hila+(rlu)+k
hulipkaidjutikhanik	huli+pka+(i)+djut+ikha+nik
qauq	qa+(uq)
katimajut	kat+ima+(ju)+t
mun	(m)+un
munagiyainik	munag+i+(ya)+i+nik
itkalruq	it+ka+(lru)+q
tukkaqtaa	t+uk+(ka)+qtaa
ubluq	ub+lu+(q)
kukiktuq	ku+(ki)+kt+uq
naqhaq	na+(qha)+q
iiqtuq	i+(i)+qtuq
ajuqhautiqaqtuq	ajuq+ha+(utiqa)+qtuq
akiliktauvaktut	ak+ili+(ktau)+vak+tut
atuqtaulluaktukhat	at+uqtau+(lluaktu)+khat
kigut	ki+(gu)+t
tuik	tu+(i)+k
havakaffuktununlu	hav+ak+(a)+ffuktunun+lu
kapuutit	ka+pu+(uti)+t
anmuujuq	an+(mu)+u+juq
anuqhiqtuq	a+nu+q+h+(i)+qtuq
kapihijuq	ka+(pihi)+j+uq
itijuq	(it)+i+j+uq
kangiqhuk	ka+ngi+(qhu)+k
covid	co+(vi)+d
irinahuktuq	iri+na+(hu)+kt+uq
aulaalimaiguvitluuniit	aula+a+(limai)+guvit+lu+uniit
amiraijaijuq	a+mir+(aija)+i+j+uq
hilahiut	hila+(hi)+ut
ininikhijuq	ini+(ni)+khi+juq
kapuutikhatikhaq	ka+pu+(utikha)+ti+khaq
kivgaqtuqhugit	kivgaq+tu+(q)+hu+git
tunguttuq	tu+(ngu)+tt+uq
qajaq	(qaja)+q
uqauhirijaa	uq+au+(hi)+rijaa
qaffaktaqtuq	qa+(ffa)+kta+qtuq
akhatquq	ak+ha+(tqu)+q
atquti	a+(tqu)+ti
kanivaut	ka+(niva)+ut
maniit	ma+ni+(i)+t
tuujjaarnaqtuq	tu+(ujjaa)+rn+a+qtuq
maliktakhaliuqtit	mal+i+(ktakha)+liuq+tit
uaqhit	(uaqhi)+t
tagiuqtuq	ta+(gi)+u+qtuq
hivunikhaqhiuqtuq	hivun+(ikhaqhi)+u+qtuq
huirungnaitillugit	hu+(irungnaitil)+lu+git
qulittaq	qu+l+(itta)+q
aqhaluktuq	aq+ha+(lu)+kt+uq
ihuaqtuq	i+hu+(a)+qtuq
aullapkaidjutingnikhavaakhat	a+ulla+pka+(idjut)+ingn+ikhava+a+khat
niuqhijuq	ni+(uqhi)+j+uq
qiniqhiajaa	qin+iqhi+(a)+jaa
akiraqatigiiktuk	aki+ra+(qatigi)+iktuk
titqauti	ti+(tqa)+uti
kinaatqin	ki+(na)+a+t+qin
nangutiqatigiiktuk	na+nguti+(qatigi)+iktuk
igunaq	ig+(un)+aq
ujaraktujuq	ujara+(ktu)+j+uq
qaptirun	qap+(tir)+un
qanga	qa+(nga)
hamlatkunillu	ham+l+at+(kuni)+llu
iluaniilluni	ilu+(aniillu)+ni
kihajjariktuq	ki+(hajjari)+kt+uq
tikitinnata	t+iki+(tinna)+ta
nutaqqangit	n+utaqq+(a)+ngit
tariuliqtuqtaa	tari+(uli)+qtuq+taa
nattiqtuq	na+(tti)+qtuq
qaqautaq	qa+(qa)+ut+aq
hanahimajaa	ha+na+(hima)+jaa
ihuaqtunik	i+hu+(aqtu)+nik
nangiqtuq	nang+(i)+qtuq
pivalliadjutikhangit	pi+vall+i+(adj)+utikh+a+ngit
alatjutikkut	al+a+(tj)+ut+ikkut
ikpiguhungniq	ik+pi+(guhu)+ng+niq
qagaqtaun	qa+g+(aqta)+un
ailaq	a+(ilaq)
naalaun	na+(ala)+un
qanilruq	qa+ni+(lru)+q
nuliilgahuk	nul+i+(ilgah)+uk
ihuarhaitjutinik	i+huarha+(itjut)+i+nik
irnillak	irn+i+(lla)+k
ihuaqhaqhimayutlu	i+hu+(aqha)+q+hima+yut+lu
uqaqtauvakhimayait	uqa+(qtau)+vak+hima+ya+it
aippaagutqikpat	a+ipp+(aagutqi)+kp+at
tirikhaq	tiri+(kha)+q
ugjunik	(ugju)+nik
ihumagiyaitigut	i+hum+(agiya)+it+igut
inuaqtuq	inu+(a)+qtuq
kivviti	ki+(vvi)+ti
kivanmut	kiv+(an)+mut
malriak	mal+(ria)+k
agjaqtuq	a+(gja)+qtuq
ubluriaq	ub+lu+(ria)+q
inuuhuktuq	inu+uhuktu+(q)
takuglugit	taku+(g)+lu+git
quanaqquhi	quana+qq+(uhi)
aquun	(aqu)+un
atuqtakhaqqut	at+uqt+(a)+khaq+q+ut
tajarniq	ta+(ja)+r+niq
anuqhaaqtuq	a+nu+q+h+(aa)+qtuq
laisimingni	lais+(i)+mi+ngni
maligaliqutitlu	mal+ig+aliq+(uti)+tlu
qablunaatut	qa+blu+(naat)+ut
finger	(finger)
naviktuq	na+v+(i)+kt+uq
hiqiniqpulaliqtuq	hi+qiniq+(pula)+li+qtuq
nigituraqtuq	ni+g+(itur)+a+qtuq
aluun	a+(lu)+un
hiut	(hi)+ut
illuktuq	(illu)+kt+uq
atanikittumi	a+(ta)+nik+ittu+mi
ayungnautiqaqqanik	ayu+ngna+(utiqaq)+qa+nik
takunnaqtuq	taku+(nna)+qtuq
nunaliuyut	nuna+(li)+uyut
munagidjutikhangitlu	munag+i+(djuti)+kha+ngit+lu
nunaqaqhimajut	nuna+(qaq)+hima+jut
titiraqtuq	titir+a+(qtu)+q
haumingni	ha+(umi)+ngni
nalariaq	na+(la)+riaq
maniliqidjutingnik	man+ili+q+(idj)+ut+ingn+ik
naammajjavutit	naamma+jj+av+(uti)+t
atuqtitpaktaillu	at+uqt+(itpa)+kta+i+llu
ilitturipkaidjutivikhatigut	ili+t+turip+ka+(idjut)+ivi+khat+igut
havguti	ha+(vg)+uti
igloolik	i+(gloo)+lik
itipjaaq	(itipjaa)+q
maliqatqujaujut	mal+iq+atquja+u+(ju)+t
piksasuuqtuq	pi+(ksasuu)+qtuq
aalliraujaq	aall+(ira)+uja+q
tuvak	(tuva)+k
aullarnatin	a+ulla+(rna)+tin
avaalaqiaq	ava+(alaqi)+aq
uqauhiup	uq+au+(hi)+up
aippiut	a+ipp+(i)+ut
manikhat	man+ik+ha+(t)
titiqiqidjutiliqiyunik	titiq+iq+(idjut)+iliq+iy+u+nik
itqanaiqtuq	itq+(ana)+i+qtuq
havangtinnagu	hav+ang+(tinna)+gu
ataaguuqtaa	at+a+(aguu)+qtaa
nipitirun	ni+pit+(ir)+un
qiku	qi+(ku)
aullaqatititluunniit	a+ull+aq+(atitit)+lu+unni+it
qutangajuq	qu+(ta)+nga+juq
igluqpaqarviit	igluqpa+(qarvi)+it
pitquhiliqijillu	pit+q+uhi+(liq)+iji+llu
qirnangajuq	qi+(rna)+nga+juq
greg	(greg)
qutuk	qu+(tu)+k
nuliariik	nul+i+(ariik)
imiqtaut	(imiqta)+ut
ihumagiyatik	i+hum+(agiya)+tik
malruuktaqtut	malru+(ukt)+aqtu+t
agiaq	a+(gi)+aq
makaqhuqtuq	m+ak+(aqhu)+qtuq
piquyat	pi+(quya)+t
quviagijaa	qu+(via)+gijaa
kigutigikhauti	kigut+(igikha)+uti
tuulliktuq	tu+(ulli)+kt+uq
aulapkaiyi	aula+pka+(iyi)
kiinaujatigut	ki+ina+(uj)+at+igut
aannuraangijaqtuq	a+an+n+(uraang)+ija+qtuq
talvnai	ta+lv+(nai)
ilauyudjutikhanik	il+au+(yu)+djut+ikha+nik
humunngaqqa	hum+unng+(aqq)+a
ugjullak	(ugju)+llak
aulajuq	a+u+(la)+j+uq
maniliurutikhat	man+(iliur)+utikh+at
iqilgagiaq	iq+(ilga)+gi+aq
aquut	(aqu)+ut
immiugaq	im+mi+(u)+gaq
iqqakuuruti	iqqaku+u+(r)+uti
tallimat	t+al+(lima)+t
tuhaqtitiyaangat	tuhaqt+(iti)+yaang+at
quunilaqijuq	qu+un+(ilaq)+i+j+uq
hakugiutikhanik	haku+(gi)+utikh+a+nik
ilihaliarpaarvingmi	ili+ha+(liarpaa)+rvi+ngmi
mirraq	(mir)+raq
angiyuqaanguvakhimayurlu	ang+(iyuqaangu)+v+akhima+yurlu
miriaqtuq	mir+(i)+a+qtuq
hakugiktuq	haku+(gi)+kt+uq
ikittijuq	ik+it+t+(i)+j+uq
havaagilluanggit	hav+aa+(gillua)+ng+git
nappaqtirnikkut	na+pp+aqt+(ir)+nik+kut
niurutikhaliqinikkut	n+iur+(utikha)+liq+inikk+ut
iijji	i+(ijji)
crowberry	(crowberry)
ihuaqhilugillu	i+hu+(aqhi)+lu+gi+llu
kinguq	ki+(ngu)+q
imaiqtittuq	ima+(iqt)+ittuq
atqunarnirujuq	atquna+rn+(ir)+u+juq
katitiqhimayut	k+at+iti+(q)+hima+yut
havaktiit	hav+akt+(i)+it
inuhaaq	inu+(ha)+aq
nunap	nuna+(p)
havaaqaqtut	hav+a+(aq)+aqtu+t
niuviqtittiviit	ni+uv+i+(qtitti)+vi+it
ikayuutiqvikhaat	ik+ayu+(utiqvikha)+at
havangnanga	hav+ang+(na)+ng+a
hinaani	hi+(na)+ani
ulapqijuq	ul+apq+(i)+j+uq
havaktiliriniq	hav+akt+(ilir)+in+iq
nunguani	nu+(ngu)+ani
piffi	pi+(ffi)
tuvjaqhijuq	tu+(vjaqhi)+j+uq
aadjikiiknahuarlugit	aadji+ki+ik+(nahuar)+lu+git
makpiraaqarvik	makp+(ira)+aq+arvik
qaalluviaq	q+aall+uv+(i)+aq
hivulliutiyukhat	hivul+li+(uti)+yu+khat
tamamnuk	t+ama+(m)+nuk
atungaq	at+u+(ng)+aq
aniqhaaktuq	a+niq+ha+(a)+kt+uq
im’rut	(im’r)+ut
jubileemik	jubi+l+(ee)+mik
angiqpak	angi+(qpa)+k
tuqujuq	tu+(q)+u+juq
inuuhiringnaqtumiklu	inu+(uhiringnaqtu)+mik+lu
pigilraaqtagharijaanni	pi+(gi)+lraaqta+gha+rijaa+n+ni
atuun	a+(tu)+un
aikhiqtuq	(aikhi)+qtuq
kiijaa	ki+(i)+jaa
ilihaqtittihimajut	ili+ha+(qtitti)+hima+jut
hanalrutikhanik	ha+na+(lr)+utikh+a+nik
kinamik	ki+(na)+mik
taktuk	ta+(ktu)+k
ugjugaq	(ugju)+gaq
pijariiqtaa	pi+(jarii)+qtaa
pitquijuq	pi+(tqu)+i+j+uq
havaktitinikkut	hav+akt+(iti)+nik+kut
uqaqtitauvakhimayuq	uq+aqt+(itau)+v+akhima+yuq
hiurjuk	hiurju+(k)
pattitigijaa	pa+(ttiti)+gijaa
ukpatik	ukp+(a)+tik
iluittunnguqtuq	ilu+(ittunng)+u+qtuq
haulluti	ha+(ull)+uti
aviktuqvingnunlu	aviktuqving+n+(un)+lu
havaut	hav+a+(u)+t
huqullaaqtuq	hu+qu+(lla)+a+qtuq
qaritauyaliqidjutingni	qa+r+it+auyal+iq+(idjut)+ingn+i
taapkuningalu	t+a+a+p+(kuni)+nga+lu
ungirut	(ungir)+ut
upautiyaangatlu	u+pa+(uti)+yaang+atlu
aajjigiiktuk	a+(ajjig)+i+iktuk
piqhiqtuq	pi+(qhi)+qtuq
tahiraq	ta+hi+(ra)+q
hamlatkunit	ham+l+at+(kuni)+t
hallaaqtuq	ha+(lla)+a+qtuq
maniktarvikhainik	man+ik+ta+(rvi)+khai+nik
uumman	uumm+a+(n)
kiluuttaqtaq	(kiluutt)+aq+taq
aajjikkutaa	aajj+ikk+uta+(a)
ihuaqhainikkut	i+hu+(aqha)+inikk+ut
ublu	u+(blu)
kiihijuq	ki+(ihi)+j+uq
mingulilaqijuq	mingul+(ilaq)+i+j+uq
niripkaqtaa	ni+r+(ipka)+qtaa
qaqquliuqtuq	qa+q+qu+(li)+u+qtuq
kataktuq	ka+(ta)+kt+uq
avatiliqiyitkutni	av+at+(i)+liq+iyit+kut+ni
tallimiut	t+al+(limi)+ut
attit	a+(tti)+t
ihivriuqtuq	ihivr+i+(u)+qtuq
kigutaijaqtaa	kigut+(aija)+qtaa
aaq	(a)+aq
kingumut	ki+(ngu)+mut
naunaqtuq	naun+(a)+qtuq
qilgiriaqtuq	qilg+ir+(i)+a+qtuq
hivunikhainnik	hivun+(ikha)+in+nik
ilannamingnut	i+la+(nna)+mi+ng+nut
ilgaak	(ilga)+ak
ihuuq	i+(huu)+q
upin’ngaaq	upin’nga+(a)+q
iepngit	(iep)+ngit
tigumiaqtiuyut	(tigumia)+qti+u+yut
upalunggaiyaunik	u+pa+(lunggaiyau)+nik
quqtuqqak	qu+(qtu)+q+q+ak
imaiqtuq	i+(ma)+i+qtuq
apittaaq	ap+(itta)+aq
kapuqhirumangitkumik	ka+pu+(qhi)+ruma+ngit+ku+mik
urjuk	u+(rju)+k
havaangit	hav+a+(a)+ngit
ingattaqtuq	ing+(att)+a+qtuq
ukununga	(ukunu)+ng+a
ujurukhaq	(ujuru)+khaq
aniutaqtuq	a+ni+(uta)+qtuq
hunak	hu+na+(k)
naunaitkutikhat	na+una+it+(k)+utikh+at
hanahuillun	ha+na+(huill)+un
tuklianik	t+uk+(li)+a+nik
amaamaut	a+(maama)+ut
imiarjijuq	i+(miarj)+i+j+uq
naammajjavutik	naamma+jj+av+(u)+tik
alliaqtuqtuq	a+ll+(i)+aqtu+qtuq
kigutigikhaqtuq	kigut+(igikha)+qtuq
un’nguq	u+(n’ng)+uq
ajuqhautiqaqhimajuq	ajuq+ha+(utiqaq)+hi+majuq
titirarvigijaa	titir+a+(rvi)+gijaa
qaniaqtuq	qa+ni+(a)+qtuq
qausuittuq	qa+(usu)+ittuq
qattinnaktuq	qa+t+(tinna)+kt+uq
qupanuaqpaarjuk	qu+pa+nu+(aqpa)+ar+ju+k
uaqhivik	(uaqhi)+vi+k
takunnaittuq	taku+(nna)+ittuq
ubluqhiuti	ub+lu+(qhi)+uti
unaaq	un+(a)+aq
halraqtuq	ha+(lra)+qtuq
attirluaqtuq	att+ir+(lu)+a+qtuq
hiqiniq pulaliqtuq	hi+qiniq+( pula)+li+qtuq
auktirun	auk+(tir)+un
qamanittuaq	qa+man+(ittu)+aq
iniqtauyukhaq	ini+(qtauyu)+khaq
pittaq	pi+(t)+taq
taapkuatluat	t+a+a+p+(kuatlu)+at
haki	ha+(ki)
ungahikhijuq	ung+a+(hi)+khi+juq
tahamaniittunun	ta+ha+ma+ni+(ittu)+n+un
ayuikyuumigumik	a+(yuikyuumi)+gu+mik
qiliqtuq	qi+(li)+qtuq
nutaanguqtirnikkullu	n+uta+a+ng+(uqtir)+nik+kul+lu
kiinaq	ki+ina+(q)
manliurnikkut	man+(liur)+nik+kut
nanminigiyaingit	na+nmin+(igiya)+i+ngit
uhiliqpallaaqtuq	u+(hiliqpalla)+a+qtuq
qugluktaaqtuq	qu+glu+(k)+taa+qtuq
niviqtuq	ni+(vi)+qtuq
nangmautaq	nang+(ma)+ut+aq
ulu	u+(lu)
nakuuyut	(naku)+uyut
nunagijapta	nuna+(gijap)+ta
havakviata	hav+ak+(via)+ta
puvak	pu+(va)+k
maniqarvikhat	ma+ni+(qarvi)+khat
kinguliq	king+ul+(i)+q
qiviuq	qi+(vi)+uq
ubluirvia	ub+lu+(i)+rvi+a
malrik	mal+(ri)+k
uukturutit	uuk+tu+(r)+uti+t
uvagut	uva+(gu)+t
qilaujjaqtuq	qi+la+(ujj)+a+qtuq
piqati	pi+(qa)+ti
ajapqumiarvik	aj+apq+(umi)+arvik
nirihuiqtunga	niri+huiq+(tu)+ng+a
hanaqijuq	ha+na+(q)+i+j+uq
ungataani	ung+a+(ta)+ani
pigiaqaqtun	pi+(giaq)+aqtun
kangiqtugaapkik	ka+ngi+(qtu)+ga+apkik
ingilradjutikhanginik	i+ngi+(lradj)+utikh+angi+nik
ilingajuq	ili+(nga)+j+uq
kingullirmi	king+ul+(lirmi)
kulavak	ku+(la)+vak
nunalaani	nuna+(la)+ani
qangiakhaq	qa+ngi+(a)+khaq
takuyaaqtut	t+ak+(uya)+aqtu+t
ukuallu	u+ku+(a)+llu
nipittuq	n+ip+(i)+tt+uq
kanajuq	ka+(na)+j+uq
nunamunngaqhuni	nuna+(munng)+aqhu+ni
kiguangirnaq	ki+gu+(angi)+rnaq
imannaq	ima+(nna)+q
inuqarniriit	inu+(q)+ar+nir+iit
algumuuqtuq	algu+(mu)+u+qtuq
havaakhanut	hav+a+(a)+kha+nut
nakkaqtuq	na+(kk)+a+qtuq
nujaittuq	nu+(ja)+ittuq
tuktut	tu+(ktu)+t
qaajurnaqtuq	qa+(aju)+rn+a+qtuq
malrungnik	malru+(ngni)+k
titiqqiqhijuq	t+itiq+q+(iqh)+i+j+uq
uhiijaqtuq	(uhi)+ija+qtuq
atuqluni	at+u+(q)+lu+ni
qatiggaaqtuq	qa+tig+(ga)+a+qtuq
pitjutinik	pi+(tj)+uti+nik
akuliarikhijuq	(akuliari)+khi+juq
ubluqhiun	ub+lu+(qhi)+un
piqtuq	(pi)+qtuq
ukunungalu	(ukunu)+nga+lu
kigliq	ki+(gli)+q
ikuhingmiktaa	iku+(hi)+ng+mik+taa
aluktuq	a+(lu)+kt+uq
havaktiangit	hav+akt+(i)+a+ngit
nuvirharniq	n+uvi+(rhar)+niq
qajangnaqtuq	qa+(ja)+ngna+qtuq
upalungiarutikhangit	up+a+lu+ng+(iar)+utikh+a+ngit
pivalliayangat	pi+vall+i+(ayang)+at
qimaktailugit	qi+(maktai)+lu+git
uqquuquti	uq+qu+(uq)+uti
angilrauhiqtuq	angil+ra+(uhi)+qtuq
munariplugitlu	mu+na+(r)+iplu+git+lu
mista	mi+(sta)
hiurjuktuuq	hiurju+(ktu)+uq
avittaa	avi+(t)+taa
aullarnanga	a+ulla+(rna)+nga
havagvia	hav+a+gv+(i)+a
kinalikaaq	ki+(nalika)+aq
qakkuriktuq	qa+(kkuri)+kt+uq
nalujaa	na+(lu)+jaa
nuvijaa	nu+(vi)+jaa
kipaqati	kip+(aqa)+ti
nungulaittumun	n+ungul+a+ittu+(m)+un
kapuukhirunaittut	ka+pu+(ukhiruna)+it+tut
nurraq	nur+ra+(q)
tipjarluktuq	tip+(jarlu)+kt+uq
qilaqqaun	qi+la+(qqa)+un
nuitajuq	nu+(ita)+j+uq
higaarluk	hig+aa+(r)+lu+k
talvani	ta+lv+(a)+ni
hauniq	ha+(u)+niq
aittuqtaa	a+(ittu)+qtaa
tuktuvallak	t+uk+(tuva)+llak
turraarvikhangit	tu+(rra)+arvik+ha+ngit
ulukhaqtuuq	u+lu+(khaqtuu)+q
mamaqhungnittuq	ma+ma+q+(hungn)+ittuq
titiraqhimayut	titir+a+(q)+hima+yut
ivitaaruq	ivita+(a)+r+uq
angitqiyaniklu	angi+(tqiya)+nik+lu
qakugu	qa+(ku)+gu
havagviat	hav+a+gv+(i)+at
ulapqinirmut	ul+apq+(i)+ni+rm+ut
hanaji	ha+na+(ji)
tagjaaqtuq	ta+(gja)+a+qtuq
aqilgiq	aqil+(gi)+q
ipirakhat	ip+(ira)+khat
annuktuq	an+nu+(ktu)+q
qaritauyaviliqinikkut	qa+ritauya+(vi)+liq+inikk+ut
ilulilik	il+(uli)+lik
ipigaun	ip+(iga)+un
nunakkullu	nuna+(kku)+llu
cgs	(cgs)
qitaujaq	qi+(ta)+uja+q
imakkuurniq	ima+(kkuur)+niq
qihik	qi+(hi)+k
hivayautaa	hivay+a+(u)+taa
pivalliayaangat	pi+vall+i+(a)+yaang+at
ingniquti	ing+niq+(uti)
angiptak	angi+(pta)+k
aannialirnaittumik	a+anni+a+(lirnait)+tu+mik
annguti	a+(nng)+uti
kuniktaa	(kuni)+kt+a+a
igjuuk	i+(gju)+uk
mirriaqtarluniluunniit	mirria+(qtarlu)+nilu+un+ni+it
nurraittuarjuk	nur+ra+(ittu)+ar+ju+k
pitikhik	pi+ti+k+(hi)+k
nivaktuq	(niva)+kt+uq
tamainik	t+ama+(i)+nik
miqhuqtuq	mi+(qhu)+qtuq
uvanga	(uva)+ng+a
havikhavikhaq	hav+(ikha)+vikhaq
nirrit	ni+r+(r)+it
aullarnani	a+ulla+(rna)+ni
ungahikkutigiiktut	ung+a+(h)+ikkut+ig+iik+tut
tuhaumapkaitjutinik	tu+h+aum+a+pka+(itjut)+i+nik
qaangiqtaa	qa+(angi)+qtaa
aaktuqtuq	a+(aktu)+qtuq
ayuilugitlu	ayu+(i)+lu+git+lu
inuuhikhanut	inu+(uhi)+kha+nut
kigun	ki+gu+(n)
qauyihainirnik	qa+uyi+ha+(i)+nir+nik
aullarnanuk	a+ulla+(rna)+nuk
ihivriurningit	ihivr+i+(urn)+i+ngit
ilihaiji	ili+ha+(i)+ji
ilaujut	i+la+(uj)+ut
qingaq	qi+(ng)+aq
nalvaaqhiutikharni	(nalva)+aq+hi+uti+khar+ni
hivayaqtukharnik	hivay+a+(qtu)+khar+nik
patiktaa	p+at+(i)+kt+a+a
ulapqiujaqtuq	ul+apq+(i)+uja+qtuq
amaulikkaaq	ama+(uli)+kkaaq
tuuq	tu+(u)+q
kukkikniq	(kukkik)+niq
kipkaqtuq	kip+(k)+a+qtuq
pidjutikhainik	pi+(dj)+utikh+a+i+nik
titirauhiq	titir+a+(uhi)+q
ukunani	uk+(un)+ani
qurlurniq	qu+(rlu)+r+niq
qablunaaq	qa+blu+(na)+aq
nauliktaa	na+(uli)+kt+a+a
nattiaq	na+(ttiaq)
pujuq	(p)+u+juq
tivjarluktuq	t+ivj+(arlu)+kt+uq
haattuq	ha+(a)+tt+uq
aliqti	al+i+(q)+ti
iji	(i)+ji
itqujaq	it+qu+(ja)+q
aqhailitaq	aq+ha+(ili)+taq
atauhiujuq	at+a+(uhi)+u+juq
havaqkvia	hav+a+(qk)+via
ilvit	i+(lvi)+t
aullaqtinnatik	a+ull+aq+(tinna)+tik
munagiyakhaingit	munag+i+(yakha)+i+ngit
publiun	pu+(bli)+un
nunatigutlu	nuna+(t)+igut+lu
pualrihaqtuq	pu+alri+(ha)+qtuq
hanaqidjutikharnik	ha+n+aq+idjut+(i)+khar+nik
igluqpanik	igluqpa+(ni)+k
aallanguqtihimajait	aall+a+(ngu)+qti+hima+jait
huvak	(hu)+vak
aulahimaarniaqtuq	aula+(himaarni)+a+qtuq
kiglingani	ki+(gli)+ng+a+ni
hunagaq	hu+na+(g)+aq
kavamatkunni	ka+(vama)+tk+un+ni
aulapkaiyiingit	aula+pka+(iyi)+i+ngit
piqaqtun	pi+(q)+aqtun
pualrihaqtaa	pu+alri+(ha)+qtaa
qunguhiqtaun	qu+ng+u+(hiqta)+un
hanajaa	h+an+(a)+jaa
upalungairutikhangit	up+a+lu+ng+(air)+utikh+a+ngit
maliktut	mal+i+(ktu)+t
aalla	a+(alla)
aku	a+(ku)
ilitturijauhimajut	ili+t+tur+(ijau)+hima+jut
kanatami	ka+na+(t)+a+mi
najakhaq	na+(ja)+khaq
pinahuarutingit	pi+nahu+ar+u+(ting)+it
uniaqtuq	un+(i)+a+qtuq
kasiliiqtuqtut	ka+s+ili+(iqt)+uq+tut
avaliittuq	ava+(li)+ittuq
havakvingnik	hav+ak+(vi)+ng+nik
algaun	alg+(a)+un
hakongak	ha+(konga)+k
higjariaq	hi+(gja)+riaq
ayuiqhimayat	ayu+i+(qhima)+ya+t
naunaiyaiyaangat	naun+a+iya+(i)+yaang+at
kigutiliqiji	kigut+(i)+liq+iji
ikumadjutiini	iku+(ma)+djut+iini
ikayukhimaanginaqtun	ikayukhi+ma+angi+(n)+aqtun
hamlatkunullu	ham+l+at+(ku)+n+ullu
nipikhaut	n+ip+(ikha)+ut
tupagumitaaqtuqtuq	tu+p+(agumita)+aqtu+qtuq
tikitpata	t+iki+(tp)+at+a
publa	p+ub+(l)+a
aannuraaqarvik	a+an+n+(ura)+aq+arvik
ilikkuurujuq	ili+(kkuur)+u+juq
hatqiumayuniklu	ha+tqi+(umayu)+nik+lu
anurikittuq	a+nur+(i)+k+ittuq
aulatitilihaartiluni	aula+tit+(ilihaarti)+lu+ni
atuqhugu	at+u+(qhu)+gu
atuaqtaun	at+u+(aqta)+un
kavamatkuni	ka+(vama)+tk+uni
kialaqijuq	ki+(alaqi)+j+uq
ilihaqtittinighakkullu	i+li+ha+(qtitti)+ni+g+hak+k+ullu
tuhunnaq	tu+(hunn)+aq
iqquq	(iqqu)+q
taivagait	ta+i+(vaga)+it
alianaigijaa	al+ia+na+(i)+gijaa
aqiaruaqtailivut	a+qi+aru+(aqtailiv)+ut
punniq	pu+(nni)+q
qaritauyakkuurutaani	qa+ritauya+(kkuur)+u+taa+ni
tunihijuq	tu+ni+(hi)+j+uq
uliisiqtuq	uli+(is)+i+qtuq
nakit	na+(ki)+t
hivuqqamun	hiv+(uqqam)+un
qajangnaitkutikhanik	qa+j+ang+na+it+(k)+utikh+a+nik
mihuraq	mi+(hu)+raq
niujijuq	ni+(uji)+j+uq
tamaphi	t+ama+(phi)
atqun	a+(tqu)+n
havakvingnit	hav+ak+(vi)+ngni+t
imiqtaqtuq	(imiqta)+qtuq
ilulliik	ilu+(lli)+ik
pinahuarutikhanik	pi+nahu+ar+u+(ti)+k+ha+nik
humik	(hu)+mik
puhitaq	pu+(hi)+taq
kimik atiqaqqin	ki+(mik )+a+tiqaq+qin
himauhiplugitlu	hi+(mauh)+iplu+git+lu
aliktuqtaa	al+i+(ktu)+qtaa
anuraaqtuq	a+nur+(a)+a+qtuq
niviuvak	n+ivi+(uva)+k
hiqanaakhiut	hiqan+a+a+k+hi+(ut)
pihukhimmaaqtillugu	pi+hu+(khimmaa)+qti+llu+gu
titiraqhimablugit	ti+tiraq+hi+ma+(blu)+git
uhiaruti	(uhiar)+uti
patau	pa+ta+(u)
aquijuq	(aqu)+i+j+uq
hivayaqlugu	hivay+a+(q)+lu+gu
aanniqtailinirmut	a+anni+(qtaili)+ni+rm+ut
nujuaqtujuq	nuju+(aqtu)+j+uq
hain’rihuktuq	hain+’ri+(hu)+kt+uq
taluq	ta+(lu)+q
ikuallaktuq	iku+(alla)+kt+uq
ikuallautikhaq	iku+(alla)+utikh+aq
halumailruq	ha+(lumail)+r+uq
apiqhuiji	ap+iq+(hu)+ij+i
avalliq	ava+(lli)+q
algaut	alg+(a)+ut
uqqariktuq	(uqqari)+kt+uq
ipijuq	ip+(i)+j+uq
ayungnautiqaaqyuaqan	ayu+ngna+(utiqa)+aq+yuaqan
quanaqpiaqqutin	quana+qpi+(aqq)+ut+in
niriuktugut	niri+(uk)+tugu+t
kikiaktuqtaa	ki+ki+(aktu)+qtaa
atpa	a+(tpa)
qiniqhiayunun	qin+iqhi+a+(yu)+n+un
ikayuqluniluunniit	ik+ayu+(qlu)+nilu+un+ni+it
inukhijuq	inu+(khi)+j+uq
irnituaq	irn+i+(tu)+aq
ataniq	a+(ta)+niq
kakkiviaq	ka+(kkivi)+aq
kangiqhihurnaqtuq	kang+iqhi+(hu)+rn+a+qtuq
munngarman	mu+(nnga)+rma+n
munaqhi	mu+na+(qhi)
aputaijaqtaa	ap+(utaija)+qtaa
iluvirvik	ilu+(vi)+rvik
apun	a+(p)+un
taqak	ta+(qa)+k
attariktuq	att+a+(ri)+kt+uq
utaqqijuq	utaqq+(i)+j+uq
ilanganni	i+la+(ngan)+ni
titiqqitaa	titiq+(qi)+taa
immiuqtuq	im+(mi)+u+qtuq
higaaq	hig+aa+(q)
anginirmik	a+(ng)+inir+mik
pukaraq	pu+(kara)+q
ilihimmariktuq	ilihi+(mmari)+kt+uq
uuktuun	uuk+tu+(un)
auma	a+(uma)
attirniit	att+ir+(ni)+it
katimavik	kat+ima+(vi)+k
ingniqut	ing+niq+(u)+t
avguqtauvaktuq	av+guqta+(uva)+kt+uq
ilaranaqtuq	i+(larana)+qtuq
tipaakuun	tipa+(aku)+un
tuglia	tu+(gli)+a
katilvik	ka+(ti)+lvik
nutqangajuq	nu+(tqa)+nga+juq
ukiuq	u+(ki)+uq
anaqtuq	(an)+a+qtuq
anaujaa	a+(nau)+jaa
qaaq	qa+(a)+q
ublumi	ub+lu+(mi)
iilluut	i+(illu)+ut
aquani	(aqu)+ani
hivuralik	hiv+ur+(a)+lik
pilauti	pi+(la)+uti
ilitturipkaidjutinik	ili+t+turip+ka+(idjut)+i+nik
ihuarhaqtauhimayumi	i+huarha+(qtau)+hima+yumi
kukuktuq	ku+(ku)+kt+uq
tunijauvikhait	tu+ni+(jau)+vi+kha+it
atukkat	at+u+(kk)+at
ukiunilu	uk+i+(u)+nilu
niuviqtittiyutinminiinnaq	ni+uv+i+(qtitti)+yut+in+mi+ni+in+naq
qumniq	qu+(m)+niq
tunmirarijaa	tu+n+(mira)+rijaa
atuglugu	at+u+(glu)+gu
boddy	(boddy)
apiqhijuq	ap+iq+(hi)+j+uq
taimaatun	t+a+i+ma+(at)+un
tarjukkuuqtuq	t+ar+j+(ukku)+u+qtuq
annujjutijut	an+nu+(jjutij)+ut
arnalluq	arna+(lluq)
maniliqidjutiliqiyunik	man+ili+q+(idjut)+iliq+iy+u+nik
umingmaktuumi	umingma+(ktu)+u+mi
pualuliuqtuq	pu+al+(uli)+u+qtuq
tujurmiaq	tu+(jurmi)+aq
uuktuutikhangitnik	uuk+tu+(utikha)+ngit+nik
qaplu	qa+p+(lu)
talliman	t+al+(lima)+n
ainiaqtutin	a+(i)+ni+aqtu+t+in
hanaqitittiaqtauyukhakkut	ha+na+(qit)+ittia+qtau+yukh+ak+kut
ilikkuuqtuq	ili+(kku)+u+qtuq
titiqqittijuq	t+itiq+q+(itti)+j+uq
naalauti	na+(ala)+uti
huiqtunut	hu+(iqtu)+nut
munakhiyut	mu+na+(khi)+yut
pihiqqaiqhuni	pi+(hiqqaiqhu)+ni
aarluktuq	a+(arlu)+kt+uq
uunaqun	uun+(aq)+un
haavittuq	ha+(av)+ittuq
havaktuliqiyikkutni	hav+akt+(u)+liq+iy+ikkut+ni
aittuutigijaa	a+ittu+(uti)+gijaa
aujijaqtuqtuq	a+(ujij)+aqtu+qtuq
aagut	aa+(gu)+t
qalurautic	qa+lura+(uti)+c
ilitariyauhimayut	ilit+(ariyau)+hima+yut
apkaluktaqtuq	a+pka+(lu)+kta+qtuq
kiillinngup	ki+(illinng)+up
agluliuqtuq	a+glu+(li)+u+qtuq
kina	ki+(na)
sikuurvik	si+(kuu)+rvik
nutaqqat	n+utaqq+(a)+t
innaqtuq	i+(nna)+qtuq
humunngauyit	hum+unng+(auy)+it
atungak	at+u+(nga)+k
uquutaq	(uqu)+ut+aq
naviktaa	na+(vi)+kt+a+a
upalungaikhimayuq	up+a+lu+ng+(ai)+kh+ima+yuq
angijut	angi+(ju)+t
unaguiqhivik	(unaguiqh)+iv+ik
tamayaniklu	t+ama+(ya)+nik+lu
aqajat	a+(qaja)+t
kakilahaaq	ka+kila+(ha)+aq
maligaghanik	mal+i+(ga)+gha+nik
munagidjutikharnik	munag+i+(djuti)+khar+nik
niqinnarij	niq+i+(nnari)+j
hanajuq	ha+(na)+j+uq
tingmiyaangat	tingm+(i)+yaang+at
ingiuqtuq	i+ngi+(u)+qtuq
haamlakunnut	(haamla)+k+un+nut
nuluq	nu+(lu)+q
tivjaq	t+ivj+(a)+q
alappaaqtuq	a+(lappaa)+qtuq
atuqpaktaptingnik	atuq+pa+k+(ta)+pting+nik
atuqtakhangit	at+uqt+(akha)+ngit
hivuliqtiqaqhutik	hivul+iqt+(iq)+aqhu+tik
ilaqatigiikhutik	i+la+(qatigi)+ikhu+tik
angiqtuq	a+(ngi)+qtuq
ilihaqtuq	ili+ha+(qtu)+q
katittijuq	ka+(titti)+j+uq
nakahungnaq	na+ka+(hungn)+aq
haumingmuuqtuq	ha+(umi)+ngmu+u+qtuq
qiqijuq	q+iq+(i)+j+uq
frank	fr+(an)+k
auviq	(auvi)+q
havagviangit	hav+a+gv+(i)+a+ngit
pulaliqtuq	pu+(la)+li+qtuq
unnuaq	un+n+(u)+aq
upluqhiun	u+pl+(uqhi)+un
mamiahuktuq	(mamiahu)+kt+uq
ungirun	(ungir)+un
iglugiik	i+glu+(gi)+ik
uhiarut	(uhiar)+ut
hadjamin	ha+dja+(mi)+n
angiyuqaanguyuqlu	ang+(iyuqaangu)+yuq+lu
hamanillu	ha+man+(i)+llu
ikayuyuktut	ik+ayu+(yu)+kt+ut
kikkariktuq	ki+(kkari)+kt+uq
iqqakuurun	iqqaku+u+(r)+un
nungulaittumut	n+ungul+a+ittu+(mu)+t
qinmiarjuk	qi+(nmi)+ar+ju+k
qitiq	qi+(ti)+q
titiqqat	t+itiq+q+(a)+t
ikaaraq	ik+a+(a)+raq
kuapuriisingit	ku+apur+ii+si+(ngi)+t
nujaq	(n)+uja+q
humiliqaak	hu+mi+(liqaa)+k
ihumagiyaingit	i+hum+(agiya)+i+ngit
atuqtuujaq	at+u+(qtu)+uja+q
kiguhiqiji	ki+guhi+(q)+ij+i
angiyutlu	a+(ng)+iyut+lu
aqhaliat	aq+ha+(li)+at
haqiktaun	ha+(qikta)+un
manik	(ma)+nik
ila	i+(la)
taliq	t+al+(iq)
angulajuq	ang+u+(la)+j+uq
qianngaqtuq	qi+(anng)+a+qtuq
kuugjuami	ku+(ugju)+a+mi
naunaiyagiikhimayutlu	naun+a+iya+(giikhima)+yut+lu
uaqhiti	(uaqhi)+ti
ivjaruti	ivj+ar+(uti)
qiqittiivik	q+iq+(itti)+iv+ik
iqitquq	iq+it+(q)+uq
nauvalliapluni	na+u+vall+(ia)+plu+ni
tukhuktaa	t+uk+(hu)+kt+a+a
ungalaq	ung+a+(la)+q
titiraqti	titir+a+(qti)
qinmiqtuqtuq	qin+mi+(qtu)+qtuq
nuliilgaqtuq	nul+i+(ilga)+qtuq
tahapkuanginnaungitunut	ta+ha+p+(ku)+angi+nnau+ngit+unut
puvipqurnaqtuq	p+uv+(ipqu)+rn+a+qtuq
aullautijaa	a+ulla+(uti)+jaa
itkattuq	(itka)+tt+uq
hingirniq	hi+n+(gi)+r+niq
hiqquqtijjut	hiqquqti+jj+(ut)
makanngittuq	m+ak+(a)+nng+ittuq
puuvjaaqtuq	pu+(uvja)+a+qtuq
pijumatujuq	p+ij+u+(matu)+j+uq
tikinahuarutit	t+iki+(nahuar)+uti+t
nagjungmiktaa	na+(gju)+ng+mik+taa
naunaikhittiarumaguvit	naun+ai+(k)+hi+ttia+ruma+gu+vit
upluqtujuq	u+pl+(uqtu)+j+uq
uugaq	u+(u)+gaq
nappaqtiriyiit	na+pp+aqt+(iriyi)+it
titiqqallu	t+itiq+q+(a)+llu
manikhainik	man+ik+ha+(i)+nik
aipagiya	a+(i)+pagiya
tuhapkinikkutlu	tu+ha+(pki)+nik+kut+lu
uqauhiliriji	uq+au+(hilir)+ij+i
aki	a+(ki)
ikayutikharniklu	ik+a+(y)+utikh+ar+nik+lu
aulahimarniaqtun	aula+(himar)+ni+aqtun
amiiqtaa	a+mi+(i)+qtaa
mikinnuaq	miki+(nnu)+aq
tuniuqagiaqaqtait	tu+ni+(uqagiaqaq)+t+a+it
napuliut	na+(puli)+ut
havautit	hav+a+(uti)+t
qauyihaqtiup	qa+uyi+ha+(qti)+up
pidjutikhaliuqlutik	p+idjut+(ikha)+liuq+lutik
kiglukkuuqtuq	ki+(glukku)+u+qtuq
elizabeth	(elizabet)+h
aallannguqpataluunniit	aall+a+(nnguqpata)+lu+unni+it
aullarnahi	a+ulla+(rna)+hi
havakhimaarlutik	hav+ak+(hima)+ar+lutik
kiujuq	ki+(u)+j+uq
qinmiq	qin+mi+(q)
maniilaq	ma+ni+(ilaq)
nani	(na)+ni
quaqhalaarun	qu+aq+ha+la+(ar)+un
quanaqqutin	quana+qq+(u)+tin
uqautivagait	uq+a+ut+i+(vaga)+it
kijjilaqijuq	k+(ijjilaq)+i+j+uq
qajagijuq	qa+(jag)+i+j+uq
nunavunmiunun	nuna+(vunmi)+un+un
avgut	a+(vg)+ut
qugluktaa	qu+(glu)+kt+a+a
atajuq	a+(ta)+j+uq
igliaq	i+(gli)+aq
hiqiraqtuq	hi+(q)+ira+qtuq
ulik	(uli)+k
kihimngiurumajuq	kihimng+i+(u)+ruma+juq
tamainni	ta+(ma)+in+ni
tuattuq	tu+(a)+tt+uq
utaqqiuqtaa	utaqq+(iu)+qtaa
pualrittit	pu+alri+(tti)+t
niqi	ni+q+(i)
ihaqqut	i+haq+(q)+ut
annirutijaa	anniru+(ti)+jaa
akimanahuat	aki+ma+(nahu)+at
nuviqhaqtuq	n+uvi+(qha)+qtuq
malruk	malru+(k)
qayangnaitumik	qa+(yangnai)+tu+mik
maniillat	ma+ni+(illa)+t
pingahut	pi+(ngahu)+t
aippaangani	(aippaa)+ng+a+ni
illaktut	i+(lla)+kt+ut
munarivaktuq	mu+na+(riva)+kt+uq
aannialaqihimajun	a+anni+(alaqi)+hima+j+un
tapkua	ta+p+ku+(a)
tinguk	(ting)+uk
tuhaqtitiliqiyunik	tuhaqt+(it)+iliq+iy+u+nik
qaritauyaliqidjutaani	qa+r+it+auyal+iq+(idj)+u+taa+ni
najak	na+(ja)+k
taliqpik	t+al+(iqpi)+k
ilagiiniaqtun	ilagi+(i)+ni+aqtun
hamilaangitni	(hamilaa)+ngit+n+i
tailoffish	ta+i+(loff)+is+h
igluqpaqaqtunut	igluqpa+(q)+aqtu+nut
qaluraut	qa+lura+(u)+t
ingilraat	i+ngi+(lra)+at
hituaqtuutit	hi+(tuaqtu)+uti+t
piringajuq	pi+(ri)+nga+juq
uqquaq	uq+qu+(a)+q
arnaruhiq	arna+(ruhi)+q
hivajaaqtuq	hiv+aj+(a)+a+qtuq
havagvingni	hav+a+gv+(i)+ngni
naliak	(nalia)+k
aulapkaiyukhat	aula+pka+(i)+yu+khat
havagiaqaqtaingitlu	hav+a+(giaq)+aqt+ai+ngit+lu
apuqtuq	ap+(u)+qtuq
nunauyaliqidjutikharnik	nuna+(uyaliqi)+dj+utikh+ar+nik
qallurautitigutlu	qa+ll+(ura)+utit+igut+lu
qallutiqarvik	qa+ll+(utiqa)+rvik
havaaqhangit	hav+a+(aqha)+ngit
iqaluktuuttiarmi	iqa+luk+(tuutti)+armi
aviktuqhimayumi	av+ikt+u+(q)+hima+yumi
manikhanik	man+(i)+k+ha+nik
ikayuutikhangitlu	ik+ayu+(uti)+kha+ngit+lu
mikitigij	miki+(ti)+gij
ikkit	ikk+(it)
munagiyakhatin	munag+i+(yakha)+tin
pinahuaqtakkut	pinahu+a+(qta)+kkut
havaktauvaktunut	hav+akt+(auva)+kt+unut
malliqtuq	mal+(li)+qtuq
pivallialiuqnikkut	pi+vall+i+(a)+liuq+nik+kut
augiaq	a+(u)+gi+aq
qikiqtaq	qi+kiqta+(q)
angilrauliqtuq	angil+ra+(uli)+qtuq
tunijaa	tu+n+(i)+jaa
tigliktuq	ti+(gli)+kt+uq
aktuutauhungujuq	ak+tu+(utauhung)+u+juq
angilrauniaqpunga	angil+ra+(u)+ni+aq+punga
ivjaqun	ivj+(aq)+un
halraqtuk	ha+(lra)+qtuk
annivilittuq	anni+(vili)+tt+uq
aqhaaqtaujuq	aq+ha+(aqta)+u+juq
aqtuliqtuq	(aqtu)+li+qtuq
kajuqtuq	(kaju)+qtuq
atuqpagainnik	at+u+(qpaga)+in+nik
uuktauti	uuk+t+(a)+uti
omingmak	(omingma)+k
tikitinnagu	t+iki+(tinna)+gu
ungullauti	ungul+l+(a)+uti
qulliq	qu+(lli)+q
inmikkurutikhanik	in+mikk+(uruti)+kh+a+nik
qilgiqtuq	qilg+(i)+qtuq
qunmuktuq	qu+n+mu+(ktu)+q
ihivriungniaqtun	ihivr+i+(ung)+ni+aqtun
hiquriaqtaa	hi+qu+(ria)+qtaa
ihaqutait	i+haq+(u)+t+a+it
atuqtuq	at+u+(qtu)+q
nipiliurun	n+ip+(iliur)+un
inuilaq	inu+i+(la)+q
iguttaq	ig+(ut)+taq
pitqujaa	pi+(tqu)+jaa
qaujimaittuq	qa+(uji)+ma+ittuq
ihivriuqhiji	ihivr+i+(uqhi)+ji
tagjuq	ta+(g)+j+uq
hanalrutit	ha+na+(lr)+uti+t
publaumajuq	p+ub+(lauma)+j+uq
aulatitiyaanganik	aula+tit+(iy)+aa+nga+nik
apirijaa	a+(pi)+rijaa
patiriaqhijuq	pa+tiri+(aqhi)+j+uq
qanittuq	qan+(i)+tt+uq
alluljikkuvit	a+ll+(ulji)+k+ku+vit
aituihimaaqtunik	a+i+tu+(i)+hima+aqtu+nik
tuniyaangat	tu+n+(i)+yaang+at
havautimik	hav+a+(uti)+mik
ilautquyauvakhimayutnin	il+au+(tqu)+yauv+akhima+yut+ni+n
quinangnaqtuq	qu+(ina)+ngna+qtuq
anaqtautiliqiji	an+aq+ta+(uti)+liq+iji
imiraqtuun	i+mir+(aqtu)+un
kiluaqtuq	ki+(lu)+a+qtuq
ikayuktikhailiuktutin	ik+ayu+(kti)+khai+li+uk+tut+in
tamangni	t+ama+(ngni)
uktut	u+(kt)+ut
kuhirniq	ku+(hi)+r+niq
ulapqiujaq	ul+apq+(i)+uja+q
qiluktuq	qi+(lu)+kt+uq
havagvjiiujunut	hav+a+gv+(jiiu)+ju+nut
tukhungajuq	t+uk+(hu)+nga+juq
aumaliuqtuq	auma+(li)+u+qtuq
ikayurutit	ik+ayu+(r)+uti+t
niguaqtautinani	ni+g+(uaqtau)+tina+ni
hanaqittiaqtauyukhanik	h+an+(aqittiaqtauyu)+kh+a+nik
imiarjiraqtuq	i+(miarj)+ira+qtuq
maliqajaujut	mal+i+(qaja)+u+jut
ittuq	(ittu)+q
calvin	ca+(lvi)+n
hivuani	hiv+(u)+ani
piannauhiq	pi+anna+(uhi)+q
uaqtuq	u+(a)+qtuq
hilahiuti	hila+(hi)+uti
ukuariik	u+ku+(ariik)
piittuq	pi+(i)+tt+uq
pingahuraaqtuq	pinga+hu+(ra)+a+qtuq
abluriq	a+b+(luri)+q
nanuqtuq	na+(n)+u+qtuq
akhaluuti	a+(khalu)+uti
ajulaqtuq	aju+(la)+qtuq
takuvaktugut	taku+(vak)+tugu+t
manikkut	(ma)+nik+kut
niujuq	(ni)+u+juq
hiitquqtuq	hi+itqu+(qtu)+q
pinniittuq	pi+(nni)+ittuq
angirjuaq	ang+ir+(ju)+aq
aqiarurliqtuq	a+qi+aru+(rli)+qtuq
ekvana	(ekv)+ana
ipikharniq	ip+(ikha)+r+niq
iviangik	ivi+angi+(k)
tunu	tu+n+(u)
ippakhaani	(ippa)+kha+a+ni
tariuliaqtuq	tari+(uli)+a+qtuq
inuinnaq	inuinna+(q)
aittuutit	a+(ittu)+uti+t
ikumaniq	iku+(ma)+niq
akiti	ak+(i)+ti
ikuutautit	iku+(uta)+uti+t
akhaktuq	(akha)+kt+uq
niaqurliuqtuq	ni+a+qu+(rli)+u+qtuq
tumiruajuq	tu+mi+(rua)+j+uq
aallanik	a+(alla)+nik
qalurauti          c	qa+lura+(uti)+          c
aituqtauhimayut	(aituqtau)+hima+yut
algaiqhijuq	alg+(aiqh)+i+j+uq
anaqtaut	an+(aqta)+ut
betty	(betty)
nigiq	ni+g+(i)+q
nukatugaq	(nukatu)+gaq
niaqurluktuq	ni+a+qu+(rlu)+kt+uq
nulluk	nu+(lluk)
annuk	(an)+nuk
ilitagihimayut	ilit+(agi)+hima+yut
kihimi	ki+(hi)+mi
kipattijuq	kip+(att)+i+j+uq
tamainnut	t+ama+(innu)+t
uvinniit	uv+in+(ni)+it
aulapkainiq	aula+pka+(i)+niq
haamiruti	ha+(amir)+uti
nipliqtuq	n+ip+(li)+qtuq
qablu	qa+(blu)
ingnak	i+(ngna)+k
aktuqtaa	(aktu)+qtaa
hamilaatkuni	(hamilaa)+tk+uni
ihunngaq	i+(hunn)+gaq
havamatkuni	hav+a+(ma)+tk+uni
hikuaqtuq	h+iku+(a)+qtuq
tahapkua	ta+ha+p+(ku)+a
jenny	(jenny)
qilaun	qi+la+(un)
ilujuq	il+(u)+j+uq
nivjaaqtuq	ni+(vja)+a+qtuq
illulik	(illu)+lik
higguk	higg+(u)+k
taktakhakkut	ta+(ktakha)+kkut
angmajuq	a+(ngma)+j+uq
naunaiqyumirumaguvit	naun+ai+(q)+yumi+ruma+guvit
ilauqtuq	i+la+(u)+qtuq
naunaiyaiyi	naun+a+iya+(iyi)
pilgujuq	pi+(lgu)+j+uq
alaiqtuq	a+(lai)+qtuq
ihumaaluktuq	i+hu+(maalu)+kt+uq
nunalingni	nuna+(li)+ngni
utimut	(uti)+mut
auladjutikhat	aula+dj+ut+(ikha)+t
atqaujuq	at+(qa)+u+juq
mitqutmik	mitqu+(t)+mik
hivajauti	hiv+aj+(a)+uti
nanijaa	na+(ni)+jaa
auvvivik	a+(uvvi)+vi+k
iquutikhaun	i+qu+(utikha)+un
ministam	m+inista+(m)
hananngaut	ha+na+(nnga)+ut
naunaittut	na+una+it+(t)+ut
qanuritpin	qa+nur+(itpi)+n
kumilakiguvillu	(kumilakiguvi)+llu
imaa	ima+(a)
kaaphi	ka+ap+(hi)
hilarluktuq	hila+(rlu)+kt+uq
arlingnaqtuq	a+(rli)+ngna+qtuq
pataliqin	p+at+(a)+liq+in
qaujuq	qa+(u)+j+uq
malikhimanikkut	mal+i+(khima)+nik+kut
pingahunik	pinga+hu+(ni)+k
ihumagiyaulluunniit	i+hu+(magiyau)+llu+unni+it
anik	(a)+nik
hulilukaaktunik	huli+lu+ka+(aktu)+nik
mahaktuq	ma+(ha)+kt+uq
ikittuq	(ik)+ittuq
arnautqiik	arna+(utqi)+ik
avatait	av+at+(a)+it
ajunngitaan	a+(ju)+n+ngit+aa+n
analok	an+(alo)+k
ayukhautinut	ayu+(kha)+uti+nut
nuqitaa	nu+(q)+i+taa
qaujihaqtauniit	q+auj+i+ha+(qtau)+ni+it
hivuliqtiuyunik	hivul+iqt+(i)+uyu+nik
taliqpingni	t+al+(iqpi)+ngni
uirniq	(ui)+r+niq
aqiaruaqtuq	a+qi+aru+(a)+qtuq
kiinarni	ki+ina+(r)+ni
amaamak	a+(maama)+k
quviagiyaingit	qu+vi+(agiya)+i+ngit
aalliniq	aall+(i)+niq
tingmikhajuq	tingm+(ikha)+j+uq
aippaq	a+ipp+(aq)
tivjariktuq	t+ivj+(ari)+kt+uq
nalukhitkuvin	na+lu+(khi)+tkuv+in
kapuhigakhaittut	ka+pu+(higakha)+it+tut
umngijauti	(umngija)+uti
akikitqijaujuq	aki+(kitqija)+u+juq
pitquhimayainik	pi+(tqu)+hima+yai+nik
atan’ngujaq	a+t+an+(’ng)+uja+q
niurmiktuq	n+iur+(mi)+kt+uq
pulaaqlugu	pu+(laaq)+lu+gu
akuttijuq	ak+u+(tti)+j+uq
itibjaaqtuq	(itibja)+a+qtuq
qanirluktuq	qa+ni+(rlu)+kt+uq
tahiuqtaa	ta+hi+(u)+qtaa
imingajuq	im+(i)+nga+juq
titqiaq	ti+(tqi)+aq
pataliqun	p+at+(aliq)+un
quviahuktuq	quviahu+(ktu)+q
tuurmiaq	tu+(urmi)+aq
ajuiqhajaa	aju+(iqha)+jaa
niaqun’ngujuq	ni+a+qu+(n’ng)+u+juq
inuktitut	inu+(kti)+tut
patqujaq	p+at+(q)+uja+q
navikhimayuq	na+(vi)+kh+ima+yuq
inugiaktut	inu+(gia)+kt+ut
ulapqidjutikkut	ul+apq+(idj)+ut+ikkut
tigluun	tig+(lu)+un
havaktuq	hav+akt+(u)+q
hilarjuaq	hila+(rju)+aq
nunanut	nuna+(n)+ut
pinahuarluni	pi+(nahuar)+lu+ni
atuqtauyukhaniklu	at+u+(qtauyu)+kha+nik+lu
ilipiruq	ili+(pi)+r+uq
ajjigiiktuk	(ajjig)+i+iktuk
pilihaarnirmi	pi+(lihaar)+nir+mi
umik	(umi)+k
mipku	m+(ipku)
qallurautitlu	qa+ll+(ura)+utit+lu
kamik	ka+(mi)+k
majuaqtuq	ma+j+u+(a)+qtuq
taimaitunik	t+a+i+ma+(i)+tu+nik
allanik	(alla)+nik
inuuhiringnaqtukkut	inu+(uhiringnaqtu)+kkut
aulatjutikkut	aula+t+j+ut+(i)+kkut
nuqhutik	nu+(q)+hu+tik
huliniahuanngittunga	huli+(ni)+ahu+an+ngit+tu+ng+a
ippakhaq	(ippa)+khaq
kingmautik	ki+(ngma)+uti+k
annaktuiliqiyunik	annaktui+(liqi)+yu+nik
akiittuq	a+(ki)+ittuq
nautkutivuq	na+(utk)+uti+vuq
tuquttijuq	t+uq+ut+(t)+i+j+uq
umingmak	umingma+(k)
unniutjutinik	(un)+niutjuti+nik
kuhirnirit	ku+(hirnir)+it
ivalukhaq	(ivalu)+khaq
pihuuyarumayutin	pi+hu+(uya)+ruma+yut+in
qugjuk	q+(ugju)+k
taqturut	taq+tur+(u)+t
angmaqtirun	ang+(maqtir)+un
aahivak	a+(ahi)+vak
amigaqhuutiliqiyunik	amig+aq+hu+(ut)+iliq+iy+u+nik
aliktuq	a+(li)+kt+uq
hinigvik	hi+n+(i)+gv+ik
hinikhaq	hi+(ni)+khaq
taqturuti	taq+tur+(ut)+i
igluliuqti	i+glu+(li)+u+qti
aallat	a+(alla)+t
nipalliqtuq	n+ip+(al)+li+qtuq
angajun’nguq	ang+aju+(n’ng)+uq
nunaptingnut	nuna+(pting)+nut
uingairnaqtuq	ui+nga+(i)+rn+a+qtuq
pingahuiqtuqtuq	pinga+hu+(iqt)+u+qtuq
pualu	pu+(a)+lu
iniqtiqhimavakhimayut	i+(ni)+qtiq+hima+v+akhima+yut
ilihaijaa	ili+ha+(i)+jaa
atuliqtitinikkutlu	at+u+(liqtiti)+nik+kut+lu
muqpaujaq	(muqpa)+uja+q
tatqiqhiutainik	tat+q+iqhi+(uta)+i+nik
tingmijuq	tingm+(i)+j+uq
hukatirut	hu+ka+(tir)+ut
mikkirun	mikk+(ir)+un
nagligijaa	na+(gli)+gijaa
pakkaq	pa+(kk)+aq
hani	h+an+(i)
nauunaitkutmi	na+(uuna)+i+tkut+mi
nirjuti	ni+r+(ju)+ti
paut	pa+(ut)
tiriganniaq	tiri+(ganni)+aq
tuktuvalik	t+uk+(tuva)+lik
nanguqati	nang+(uqati)
qanik	qan+(i)+k
aullaqtuq	a+ull+aq+(tuq)
hikulihaaq	h+iku+(liha)+aq
kilgavikpak	kilg+a+vi+(kpak)
ungalaqtuq	ung+a+(la)+qtuq
mamianaq	(mamian)+aq
arniqijuq	ar+ni+(q)+i+j+uq
kikhuk	ki+(khu)+k
nunataarutaanut	nuna+(ta)+aru+taa+nut
ikayuriami	ik+ayu+(ri)+a+mi
tikinnanga	t+iki+(nna)+ng+a
havaakhat	hav+a+(a)+khat
ilituqhaiyukharnik	ilit+uqhai+(yu)+khar+nik
inukpaugamik	inu+kp+(auga)+mik
amirinikkut	a+(mir)+inikk+ut
aiviqtuq	a+(ivi)+qtuq
tapkuat	ta+p+ku+(at)
puvallaqtuq	p+uv+(alla)+qtuq
iliranaittuq	ilira+(na)+ittuq
amigaittut	amig+a+(ittu)+t
kaavjiq	ka+a+(vji)+q
piyakhat	pi+(yakha)+t
tupaaqtaa	tu+p+(aa)+qtaa
kalluguqtuq	ka+(llugu)+qtuq
kajumiittuq	(kajumi)+ittuq
avin	a+(vi)+n
tiguaqtaa	tig+(u)+a+qtaa
alianaqtuq	al+ia+na+(qtu)+q
iglupiaqtuqtuq	i+glu+(pi)+aqtu+qtuq
uqhurjualiqiji	uqhurjua+(liq)+ij+i
ilauyukharnik	i+la+(u)+yu+khar+nik
nullauhiqtuq	n+ull+au+(hi)+qtuq
pitquhituqarniriit	pit+q+uhi+(tuq)+ar+nir+iit
ikpigjuami	ik+pi+(gju)+a+mi
aaktuut	a+(aktu)+ut
qaffiuyunik	qa+(ffi)+uyu+nik
aullaaqhimajuq	a+ulla+(aq)+hi+majuq
publakhiijuq	p+ub+(lakhi)+i+j+uq
takupkaivikhaatigut	takupka+ivi+(kha)+at+igut
diamond	diam+(o)+n+d
atugiangini	at+u+(gi)+angi+ni
kivvit	kiv+(vi)+t
mivvik	mi+(v)+vi+k
ilagiik	ilagi+(i)+k
kikiak	ki+(ki)+ak
mimiq	mi+(mi)+q
igluqpainnun	igluqpa+(innu)+n
ipikhaun	ip+(ikha)+un
apurvik	apur+v+(i)+k
nigiqtuq	ni+g+(i)+qtuq
taimaa	t+a+i+ma+(a)
ihumaqhutait	i+hum+(aqhu)+t+a+it
iniqhimaittut	ini+(qhima)+it+tut
nulaq	nu+(la)+q
nunavunmiunut	nuna+(vunmi)+unut
ayuqhautit	ayu+(qha)+uti+t
ukhuviaqtaq	uk+hu+vi+(aqta)+q
qaangillu	qa+(angi)+llu
taapkuninga	t+a+a+p+(kuni)+ng+a
tingittaipkun	ti+ngi+ttai+(pk)+un
nuvihijuq	n+uvi+(hi)+j+uq
piqaqtitai	pi+(qaqtita)+i
ublaaq	(ubla)+aq
hatqiqtuq	ha+(tqi)+qtuq
iqaluktuq	iqa+luk+(tuq)
nuijaaqpak	nu+(ija)+aq+pak
piiqtaa	pi+(i)+qtaa
takhijuq	t+ak+(hi)+j+uq
pijuminaqtuq	p+ij+u+(mina)+qtuq
nipikhaun	n+ip+(ikha)+un
pualulik	pu+al+(u)+lik
haniqpaijuq	ha+(niqpai)+j+uq
humi	(hu)+mi
tamaffi	t+ama+(ffi)
munagihimaaqtun	munag+i+(hima)+aqtun
taiguaqtuq	ta+(igu)+a+qtuq
havangtinnatin	hav+ang+(tinna)+tin
nunalaangit	nuna+(la)+a+ngit
uilgaqtuq	u+(ilga)+qtuq
akiliuhiarijaa	ak+ili+(uhiar)+i+jaa
huluk	(hu)+lu+k
inuuqati	inu+(uqati)
nauligaq	na+(uli)+gaq
qannaqtujuq	qa+(nnaqt)+u+juq
nipiliuqtuq	n+ip+(ili)+u+qtuq
im’ruti	(im’r)+uti
malikhautikhat	mal+i+(kha)+utikh+at
kingmiktaq	k+ing+mi+(kt)+aq
nalukaphukhugit	na+lu+(kaphuk)+hu+git
ikkin	ikk+(i)+n
aturutinik	at+u+(r)+uti+nik
qaphinik	qa+(phi)+nik
aturvik	at+u+(rvi)+k
ilatitlu	i+la+(ti)+tlu
tikitinnagik	t+iki+(tinna)+gik
tuhaumapkaivik	tu+h+aum+a+pka+(i)+vi+k
uliuhiniq	(uliuhi)+niq
nama	na+(ma)
tigluuti	ti+(glu)+uti
atuqtauyunut	at+uqt+(a)+uyu+nut
kuungajuq	ku+(u)+nga+juq
titiqqani	t+itiq+q+(a)+ni
kaivaluaqtuq	ka+(ivalu)+a+qtuq
tukaliktuq	t+uk+(ali)+kt+uq
atukiutiyunik	at+u+ki+(uti)+yu+nik
ijaruqtuq	(ijaru)+qtuq
upin’ngaqhiqtuq	upin’nga+(qhi)+qtuq
uunnaalaqijuq	uun+(na)+alaqi+juq
ahinutlu	a+(hi)+nut+lu
uqauhiannin	uqa+(uhi)+anni+n
uqaqtainik	u+(qaqta)+i+nik
imaq	(ima)+q
laisit	lais+(i)+t
puptajuq	pu+(pta)+j+uq
humunngauliqqit	hum+unng+(auliqq)+it
angajukhaq	ang+aju+(kha)+q
angunahuaqti	ang+u+(nahu)+a+qti
aupajaaqtuq	aupajaa+(qtu)+q
atugakhangitlu	at+u+(ga)+kha+ngit+lu
kidjaumainaliqhunni	ki+(dj)+aumainaliqh+unni
napu	na+(pu)
qaritauyarni	qa+ritauya+(rni)
aullaqtinnatin	a+ull+aq+(tinna)+tin
imaatun	im+(aat)+un
arnaq	a+(rna)+q
huvaiqtuq	hu+(va)+i+qtuq
qaffitaalauyuk	qa+(ffi)+taa+la+u+yuk
aluut	a+lu+(u)+t
kauttuarminunngaqtaa	ka+uttu+(arminunng)+a+qtaa
qurluq	qu+(rlu)+q
tuvaaq	(tuva)+aq
qun’ngiaqtuq	qu+(n’ngi)+a+qtuq
mik	mi+(k)
hivuliqtiliuqtuq	hivul+iqt+(ili)+u+qtuq
itqiliq	itq+(i)+liq
apiqhuijuq	ap+iq+(hu)+i+j+uq
taliruq	ta+(li)+r+uq
pijumaphaaqtuq	p+ij+u+(mapha)+a+qtuq
uqqarikhijuq	(uqqari)+khi+juq
aannuraaqtuqtuq	a+an+n+(ura)+aqtu+qtuq
kitikmeoni	kit+(ikmeo)+ni
naunaiyaqhimayunititirauyautainnik	naun+a+iya+(q)+himayun+it+it+irau+ya+utain+nik
anguhuqtuq	ang+u+(hu)+qtuq
tamainun	t+ama+(in)+un
umilik	(umi)+lik
akiittuqtaqtuq	a+(k)+i+ittuq+ta+qtuq
uvajum	uva+(jum)
kipkaq	kip+(k)+aq
inukhuk	inu+(khu)+k
havakhimaaqpakhimayuq	hav+ak+(hima)+aq+p+akhima+yuq
pajaliqin	pa+(ja)+liq+in
ungahiktuq	ung+a+(hi)+kt+uq
imiruktuq	i+mir+(u)+kt+uq
sanirajak	sa+ni+ra+(ja)+k
kajangnaqtuq	ka+(ja)+ngna+qtuq
aallaniklu	a+(alla)+nik+lu
ikummat	iku+(mma)+t
nangiaqtuittuq	na+ngi+(aqtu)+ittuq
paun’ngaq	pa+u+(n’ng)+aq
publaktuq	p+ub+(la)+kt+uq
tatijaa	tat+(i)+jaa
upalungairutingnik	up+a+lu+ng+(air)+ut+ingn+ik
uvaptingnik	uv+(a)+pting+nik
uqaqatigilugu	uqa+(qatigi)+lu+gu
amaqqut	ama+(qq)+ut
ikayuutikhainnut	ik+ayu+(uti)+kha+in+nut
hivumuuqpalliadjutikhaptingnut	hiv+um+uu+(qpallia)+djut+ikha+pting+nut
numiqtuq	nu+(mi)+qtuq
ayuittiagiikhimayunik	ayu+it+ti+a+(giikhima)+yu+nik
higaakhaq	hig+aa+(kh)+aq
qaritauyakkut	qa+ritauya+(kku)+t
taktakhaliqinikkut	ta+(ktakha)+liq+inikk+ut
quanaqpiaqqutik	quana+qpi+(aqq)+uti+k
ulapqipkaivikhainik	ul+apq+i+pka+(ivi)+khai+nik
kanguq	ka+(ngu)+q
qujagijaa	qu+(ja)+gijaa
akurut	ak+u+(rut)
taaqhijuq	ta+(aqhi)+j+uq
hinikhaaqtuq	hi+n+(ikha)+a+qtuq
aulanginaqpaklutik	aula+(ngi)+naq+pak+lutik
haput	ha+p+(ut)
niviuvarjuk	(niviuv)+ar+ju+k
kavamaliriyitkunnilu	k+ava+mal+(iriyi)+tk+unni+lu
immiqtaa	im+(mi)+qtaa
angutikhaq	an+(g)+utikh+aq
pivikhaqautikhanut	pi+(vikhaqauti)+kha+nut
higjaq	hi+(gja)+q
nungutaa	nu+(ngu)+taa
nuutaanguqtiqhimavakhimayut	nu+uta+ang+(u)+qtiq+hima+v+akhima+yut
tingiq	ti+(ngi)+q
itquqtuq	i+(tqu)+qtuq
hamanirmiut	ha+man+(i)+rmiut
ihajuq	i+(ha)+j+uq
lowe	(lowe)
ihariattigijauninganin	iharia+(tti)+gijauni+nga+n+in
ilu	i+(lu)
ataiqtuq	at+a+(i)+qtuq
piyakhait	pi+(yakha)+it
iigijaa	i+(i)+gijaa
akiruq	a+(ki)+r+uq
atuqtakharnik	at+uqt+(a)+khar+nik
kilgavik	kilg+a+vi+(k)
maamaun	(maama)+un
havagviit	hav+a+gv+(i)+it
piiqtuq	pi+(i)+qtuq
pinahuarutit	pi+(nahuar)+uti+t
qilamik	qi+(la)+mik
amiq	a+(mi)+q
aputaijaijuq	ap+(utaija)+i+j+uq
tamaani	t+ama+(a)+ni
kingmitquq	k+ing+mi+(tqu)+q
kaangnirmit	ka+(ang)+ni+rm+it
patauliuqtuq	pa+ta+(uli)+u+qtuq
uqhurjuaqtaun	uqhurjua+(qta)+un
ingutaaqtuq	i+(ngu)+taa+qtuq
aqagu	a+(qa)+gu
ihumaliurutikhat	i+hu+(maliur)+utikh+at
ilulliq	ilu+(lli)+q
hurluktuq	hu+(rlu)+kt+uq
maliktaa	mal+i+(k)+taa
ukkuhik	uk+(kuhi)+k
quanaqpiaqquhi	quana+qpi+(aqqu)+hi
akulliquti	(akulliq)+uti
akikittuq	aki+(k)+ittuq
anirniq	a+(ni)+r+niq
aturutikhanik	at+u+(r)+utikh+a+nik
akhaluut	ak+ha+(lu)+ut
atauhiq	at+a+(uhi)+q
inuaqhutik	inu+(aq)+hu+tik
kavamangit	ka+(vama)+ngit
angujakti	ang+u+(jakti)
ilgak	(ilga)+k
nunallanutlu	nuna+(ll)+anut+lu
uummat	uumm+a+(t)
atatjutinik	at+a+(tj)+uti+nik
qimirluk	qi+(mir)+lu+k
amingnik	(a)+mi+ng+nik
haamlakunnit	(haamla)+k+unni+t
alguilitaq	algu+(ili)+taq
itiq	it+(i)+q
niriqatigingnirmik	niri+(qatigi)+ng+nir+mik
ulipkaaqtaa	uli+pka+(a)+qtaa
iijaa	i+(i)+jaa
an’rajuktuq	an’r+(aju)+kt+uq
iliuraqtauhimayuluunniit	ili+(uraqtauhimayu)+lu+unni+it
maligaliuryuarvingmun	mal+(igaliu)+ryua+rvi+ngmu+n
ihuaqtut	i+hu+(aqtu)+t
qaritaugaani	qa+(ritauga)+ani
ihuarhainikkut	i+huarha+(i)+nik+kut
ihuuqiq	i+hu+(uqi)+q
qijjaktuq	qi+(jja)+kt+uq
havaanganik	hav+aa+(nga)+nik
itaanganik	(it)+aa+nga+nik
ulujjat	u+lu+(jja)+t
uvaguk	uva+(gu)+k
timimi	ti+(mi)+mi
pijumaffaaqtuq	p+ij+u+(maffaa)+qtuq
ubluliuqtuq	ub+lu+(li)+u+qtuq
maraaqtuq	ma+(ra)+a+qtuq
haavitaa	ha+(avi)+taa
havagviani	hav+a+gv+(i)+ani
atukkiqtuq	at+u+(kk)+i+qtuq
ikayullannga	ik+ayu+(lla)+nnga
haulluun	ha+(ullu)+un
ningahuktuq	ni+(ngahu)+kt+uq
taffumungalu	ta+(ffumu)+nga+lu
ivjaruhiqtaa	ivj+ar+(uhi)+qtaa
atuqtaujjuhighaat	at+uqtau+(jju)+hi+gha+at
kitittijuq	ki+(titti)+j+uq
ayuinikkut	a+(yu)+inikk+ut
aquihimajuq	aq+u+(i)+hi+majuq
haamlatkut	ha+(amlat)+kut
qalruttuq	qa+(lru)+tt+uq
ataniata	a+t+an+(i)+at+a
hiku	hi+(ku)
aadjikkutagiktitlugit	a+(adjikkutagik)+t+it+lu+git
naalaktuqnaalaktuq	na+al+akt+uqna+al+(a)+kt+uq
agliruq	a+(gli)+r+uq
uitait	u+(i)+t+a+it
arjaijarvik	arj+(aija)+rvik
kappiahuktuq	ka+p+pi+a+(hu)+kt+uq
ikpati	ikp+(a)+ti
kapuun	ka+pu+(un)
lind	(li)+n+d
aulanikkut	a+u+(la)+nik+kut
manikharvikhanik	man+ik+ha+(rvi)+k+ha+nik
pukukkit	pu+(kukk)+it
higaaqtuq	hig+aa+(qtu)+q
qukturaq	qu+(ktu)+raq
ilaun	il+au+(n)
qiniqhinait	qin+iqhi+(na)+it
aputtaaq	ap+(utta)+aq
havakviit	hav+ak+(vi)+it
nunangni	nuna+(ngni)
aullapkaidjutingnik	a+ulla+pka+(idj)+ut+ingn+ik
tapkunani	ta+p+ku+(n)+ani
tapkununga	ta+p+ku+(nu)+nga
aituutikhaq	a+i+tu+(utikha)+q
aulatitiyukharniklu	aula+tit+(i)+yukh+ar+nik+lu
kamiktuqtuq	ka+mi+(ktu)+qtuq
ii	i+(i)
pihimanikkut	pi+(hima)+nik+kut
nigiaqtautinani	ni+g+(iaqtau)+tina+ni
angitqijaq	angi+(tqi)+j+aq
tunin’nguiqtirijuq	tu+ni+(n’nguiqtir)+i+j+uq
aqaguunnukpat	aqag+u+(unnu)+kp+at
afisiani	a+(fisi)+ani
makkaq	m+ak+(k)+aq
piksaliutiqaqtutin	pi+(ksaliu)+tiqaq+tut+in
iukkaqtuq	i+(ukk)+a+qtuq
malikhugit	mal+i+(k)+hu+git
pivalliavikhainnut	pi+vall+i+(avi)+kha+in+nut
havaqatigiiktutlu	hav+a+(qatigi)+ik+tut+lu
puvviujaq	puvvi+(uj)+aq
imaalu	ima+(a)+lu
imnaiq	im+(naiq)
qakipqajuq	qa+(kipqa)+j+uq
ilirahuktuq	ilira+(hu)+kt+uq
igluqpanun	igluqpa+(n)+un
takukkit	taku+(k)+k+it
qanikturiiktuk	qa+ni+(ktur)+i+iktuk
taaq	(ta)+aq
tui	tu+(i)
takupkaqvikhaatigut	takupka+(qvikha)+at+igut
upalunggaiyainirmun	up+a+lu+ng+(gaiyai)+ni+rmun
haglujuq	ha+(glu)+j+uq
tingmiaqpak	tingmi+(aqpa)+k
igluktuuqtuq	i+glu+(ktu)+u+qtuq
tuqutqajaktuq	t+uq+ut+(qaja)+kt+uq
anguut	ang+u+(u)+t
qunguhiq	qu+ng+u+(hi)+q
arvinilitaippaa	arvin+ilit+(aippaa)
aulattiji	aula+(tti)+ji
huliva	huli+(va)
qakuqhijuq	qa+ku+(qhi)+j+uq
unnuk	un+(n)+uk
ubluqhiut	ub+lu+(qhi)+ut
aquttuq	(aqu)+tt+uq
kivijuq	ki+(vi)+j+uq
makaqtaa	m+ak+(a)+qtaa
niglaktuq	ni+g+(la)+kt+uq
ikijjuk	iki+(jju)+k
aullaghimanuahuaqtutut	a+ulla+(g)+hima+nuahu+aqtu+tut
kajumiktuq	(kajumi)+kt+uq
ukkuhikhaq	uk+(kuhi)+khaq
qakuguttauq	qa+ku+(guttauq)
aannuraaq	a+an+n+(ura)+aq
tikitinnatik	t+iki+(tinna)+tik
akhun	a+(kh)+un
angajuqqaaq	ang+aju+(qqa)+aq
ulimakkak	uli+ma+(kk)+ak
tugliqti	tu+(gli)+qti
kalliqtuq	ka+(lli)+qtuq
ikajuutaukpiakhungujuq	ikajuut+auk+pi+akhun+(g)+u+juq
ningauk	ni+(nga)+uk
upalungairutikharnik	up+a+lu+ng+(air)+utikh+ar+nik
kinngait	ki+(nnga)+it
ikayukpaqtut	ik+ayu+(kp)+aqtu+t
kamiijaqtuq	ka+mi+(ija)+qtuq
ilphi	il+(phi)
niuvrutikhaliqinikkut	niuvr+(utikha)+liq+inikk+ut
papiqqiqijuq	pa+piqq+(iq)+i+j+uq
uqaq	uqa+(q)
qiqaijaluarvia	qi+qai+(jalua)+rvi+a
qalairaqtuq	qa+(la)+ira+qtuq
qangiutigumi	qa+ngi+(uti)+gu+mi
juus	(juus)
itiktaqtuq	(iti)+kta+qtuq
aglualiuqtuq	a+glu+(ali)+u+qtuq
kakaktuq	ka+(ka)+kt+uq
kiahik	ki+(ahi)+k
pallukaqtuq	pa+(lluk)+a+qtuq
paan’nguqtuq	pa+an’ng+(u)+qtuq
hanaidjutikhangit	ha+na+(idj)+utikh+a+ngit
ihummarluktuq	i+hu+(mmarlu)+kt+uq
paurvik	pa+(u)+rvik
ikkalruq	ikk+(alr)+uq
killaijaijuq	kill+(aija)+i+j+uq
atuqtakhanik	at+uqt+(a)+k+ha+nik
miqhuqtitaq	mi+(qhu)+qti+t+aq
pingangnaqtuq	pinga+(ngna)+qtuq
ulipkaaqtuq	uli+pka+(a)+qtuq
anikkurijuq	a+ni+(kkuri)+j+uq
hangutitaqtuq	ha+nguti+(t)+a+qtuq
itibjaaq	(itibja)+aq
upin’rakhaq	u+p+i+(n’ra)+khaq
anaqtaun	an+(aqta)+un
parnautikhaliuqtainik	pa+(rna)+utikh+a+liuq+tai+nik
aqiatuhuktuq	aq+ia+(tuhu)+kt+uq
tunihidjutikhainik	tu+ni+(hidj)+utikh+a+i+nik
tunuttuq	tu+n+(u)+tt+uq
uqumuujuq	u+qum+(u)+u+juq
tukiliurut	t+uk+(iliur)+ut
nuniq	nu+(ni)+q
qauyihaidjutikharnik	qa+uyi+ha+(i)+dj+utikh+ar+nik
qitun’ngaq	qi+tu+(n’ng)+aq
ipummiqtuq	ip+(ummi)+qtuq
ihumaliurutikhaniklu	i+hu+(maliur)+utikh+a+nik+lu
alilajuq	al+i+(la)+j+uq
arjakuurvik	arja+(kuu)+rvik
qilamiuqtuq	qi+la+(mi)+u+qtuq
taamna	ta+(a)+mna
aariarmik	a+(ariar)+mik
qablunaatun	qa+blu+(naat)+un
tatqiqhiut	tat+q+iqhi+(u)+t
tikitaa	t+iki+(taa)
ihuakhaidjutikhaniklu	i+hu+(akhaidj)+utikh+a+nik+lu
tuniyahimanngitpat	tu+ni+(ya)+hima+nngitpat
tuuqtaa	tu+(u)+qtaa
aqiaruaramik	a+qi+aru+(ara)+mik
qaphit	qap+(hi)+t
hukatirun	hu+ka+(tir)+un
majuraun	ma+j+u+(ra)+un
atugaq	a+tug+(a)+q
akulliq	(akulliq)
iiluktuq	i+(ilu)+kt+uq
maligutikhanik	mal+i+(g)+utikh+a+nik
qattarjuk	(qattarju)+k
puiguqtaa	pu+(igu)+qtaa
timait	ti+(ma)+it
iep	(iep)
tangmaarutikharnik	t+ang+ma+(a)+r+utikh+ar+nik
ayuinnirnik	ayu+i+(n)+nir+nik
tuulligaaq	tu+(ulli)+ga+aq
haanlatkut	ha+(anla)+tkut
qupilruq	qu+(pil)+r+uq
aukhittiaqhimajuq	auk+(hittiaq)+hi+majuq
huraaqhiuqtuq	hu+ra+(aqhi)+u+qtuq
ilagikmiya	ilagi+(kmiya)
tamayatit	ta+(mayati)+t
aulatitiyaangatlu	aula+tit+(i)+yaang+atlu
tahirmi	ta+(hir)+mi
havarluqutainnannguqtuq	hav+a+(rluquta)+in+nanngu+qtuq
taitai	ta+i+(ta)+i
makpiraaq	makp+(ira)+aq
alrujiqinikkut	alruj+i+(q)+inikk+ut
hungajangajuq	hu+(ngaja)+nga+juq
pittiaqtumik	pi+(ttiaq)+tu+mik
hivulliujuq	hivul+li+(u)+j+uq
itigak	(itig)+ak
inukpak	inu+(kpak)
avataani	ava+(ta)+ani
milugiaq	mi+lu+(gi)+aq
akimajuktuq	aki+ma+(ju)+kt+uq
nappannguqtuq	na+(ppanng)+u+qtuq
pualrin	pu+alri+(n)
qilirniiqtaa	q+ili+rn+(ii)+qtaa
ajaraaqtuq	a+(jara)+a+qtuq
aullaqtinnagit	a+ull+aq+(tinna)+git
qiniqhiayiiyut	qin+iqhi+a+(yii)+yut
ujuruk	(ujuru)+k
ainniq	a+(in)+niq
huna	hu+(na)
aanniarutip	a+an+n+(i)+ar+utip
minguliqtuq	mingul+(i)+qtuq
piqalujaq	pi+(qalu)+j+aq
taingna	ta+i+(ngna)
tarraq	ta+(r)+raq
tikinnani	t+iki+(nna)+ni
mitquiqtaa	mitqu+(i)+qtaa
emergency	(emergency)
ilanginiklu	i+la+(ngi)+nik+lu
ikualaarnikkut	iku+al+a+(ar)+nik+kut
titqaun	ti+(tqa)+un
aulatjutinun	aula+t+j+ut+(i)+n+un
piannaq	pi+anna+(q)
anujaa	an+(u)+jaa
qaqquq	qa+q+qu+(q)
ministanun	m+inista+(nu)+n
kivjaqtaa	ki+(vja)+qtaa
ilitquhiinut	ilit+(quhii)+nut
alraaq	a+(lra)+aq
uivitullu	u+(ivi)+t+ullu
angunahuaqtuq	ang+u+(nahu)+a+qtuq
kangiqhijaa	kang+iqhi+(jaa)
qaffinik ukiuqaqqa	qa+(ffi)+nik+ u+kiuqaq+qa
piksaliuqtaa	pi+(ksaliu)+qtaa
mallaujuq	ma+(lla)+u+juq
aulapakitjutainni	aula+p+ak+(itj)+utain+ni
annut	an+nu+(t)
allarun	a+(llar)+un
pukkuliqhit	pu+(kku)+liq+hit
ikajuqtaa	ik+a+(ju)+qtaa
qujahuktuq	quja+(hu)+kt+uq
minilaqijuq	min+(ilaq)+i+j+uq
taimaaqtuq	t+a+i+ma+(a)+qtuq
tiggutik	tig+(gu)+tik
akun’nganiittuq	ak+u+(n’ng)+ani+ittuq
aqhalingiaq	aq+halin+(giaq)
taaksiyautinik	ta+ak+si+(ya)+uti+nik
tuniyauvaktut	tu+ni+(yau)+vak+tut
ihuigiyauyunik	i+hu+(igiyau)+yu+nik
taitaiffaaqtuq	t+a+itai+(ffa)+a+qtuq
hivunikhangit	hivun+(ikha)+ngit
aqhaliaq	aq+ha+(li)+aq
qilalugaqtuq	qi+la+(lug)+a+qtuq
uqauhiingit	uqa+(uhi)+i+ngit
ubluqtuhinia	ub+lu+(qtu)+hi+ni+a
qijuvik	qi+(ju)+vi+k
mikhaanun	mi+(kha)+anu+n
palvinaqtuq	pa+lvi+(n)+a+qtuq
akin	a+(ki)+n
mamaqtuq	ma+(ma)+qtuq
aadlanutlu	aa+(dl)+anut+lu
aqagumunngaqqqat	aqagum+unng+aq+q+(q)+at
akunniq	a+(kun)+niq
uunnaaqtuq	(uunna)+a+qtuq
tikitinnagit	t+iki+(tinna)+git
aannialaqidjutit	a+anni+(alaqi)+djut+it
mirrianguyuq	mirria+(ng)+u+yuq
aquplingajuq	a+qu+p+(li)+nga+juq
inuvialuit	inu+(via)+lu+it
kuugarjuk	ku+(ug)+ar+ju+k
katuuti	ka+(tuuti)
kuugaq	(kuu)+gaq
iluani	(ilu)+ani
marluk	ma+(rlu)+k
ungirlaaq	(ungir)+laaq
aannaktuliqiyikunullu	a+an+n+(aktu)+liq+iyik+un+ullu
natiq	na+(ti)+q
niuviqtuni	ni+uv+i+(qtu)+ni
umingmaaq	umingma+(a)+q
tajarmiaq	ta+(jarmi)+aq
ayuiqpaliadjutauyut	ayu+i+(qpalia)+djut+auyut
havautikhainnik	hav+a+(utikha)+in+nik
kapukhirnirmi	ka+pu+(khir)+nir+mi
qalaktuq	qa+l+(a)+kt+uq
tunmirautit	tu+n+(mira)+uti+t
ukiaq	uk+i+(a)+q
piannarviit	pi+anna+(r)+vi+it
ikayuqpagait	ik+ayu+(qpaga)+it
havangnanuk	hav+a+(ngna)+nuk
ikayukhimaanginaanginaptingnik	ikayukhi+ma+angi+(naangina)+pting+nik
iqqanaiqtuq	iq+qa+(na)+i+qtuq
ukalaaq	uk+(ala)+aq
qanurittaaqhaanut	qa+nur+(itta)+aqha+anut
puptat	pu+(pta)+t
pidjutiqaqtut	p+idjut+(iq)+aqtu+t
niaqqulrujuq	ni+aq+qu+(lru)+j+uq
inutquaq	inu+(tqu)+aq
nguqan	(ngu)+qa+n
nipitqaqtuq	ni+pit+(q)+a+qtuq
afisimun	a+(fisi)+m+un
tuniyaulunilu	tu+ni+(yau)+lu+nilu
iijjirurvia	iijjir+(u)+rvi+a
uningajuq	un+(i)+nga+juq
ihuani	i+hu+(a)+ni
aullarnikkut	a+ulla+(r)+nik+kut
kavamangitni	ka+(vama)+ngit+n+i
ulingajuq	(uli)+nga+juq
tukiliurutiliuqtut	t+uk+(iliur)+uti+liuq+tut
atuut	at+u+(u)+t
havangnatin	hav+a+(ngna)+tin
qanuqtut	qan+(uq)+tut
igluqpautainut	igluqpa+(uta)+in+ut
urhuliqiyitkunni	urhuli+q+(iyi)+tk+un+ni
ungiruti	(ungir)+uti
mapiraangutaini	ma+(piraang)+utain+i
kakkiliqtaqtuq	ka+k+(ki)+liq+ta+qtuq
aqaguublaami	aqag+u+(ubla)+a+mi
tuqungajuq	tu+q+(u)+nga+juq
mumiqtuq	m+(umi)+qtuq
immitqiktaa	im+mi+(tqi)+kt+a+a
gaasiliikharlutin	ga+(asilii)+khar+lutin
avatingni	ava+(ti)+ngni
kappianaqtuq	ka+p+pi+a+(n)+a+qtuq
puviqhimajuq	p+uv+(iq)+hi+majuq
kuvjin	ku+vj+(i)+n
aituqtauhimaaqtunik	(aituqtau)+hima+aqtu+nik
ikaaqtuq	ik+a+(a)+qtuq
tahitirijuq	ta+hi+(tir)+i+j+uq
kivvin	kiv+(vin)
pinahuarnirmut	pi+(nahuar)+ni+rm+ut
texas	(texas)
kaipiktijjutijuk	ka+i+pikti+(jjutij)+uk
pinahuarumik	pi+nahu+ar+u+(mi)+k
aarluqtuq	a+(arlu)+qtuq
kanangnaqtuq	ka+na+(ngna)+qtuq
tuqhuuk	tuq+hu+(u)+k
aittuut	a+(ittu)+ut
atiruaqtuq	a+(tiru)+a+qtuq
hinnakturni	hi+nna+(ktu)+r+ni
amiakkut	a+mi+(a)+kkut
kaantraaknilu	ka+a+(ntraa)+k+nilu
pihimayumut	pi+(hi)+ma+yu+mut
tarrijaut	(tarrija)+ut
havakvigiyauyuni	hav+ak+(vi)+giyauyu+ni
mitquiqtuq	mitqu+(i)+qtuq
ikayuqhitini	ik+ayu+(qhi)+ti+ni
havaktinun	hav+akt+(in)+un
inuuvakhutalu	inu+(uvakhuta)+lu
piumangittunut	pi+uma+(ng)+ittu+nut
hamaltkunut	ha+mal+(tku)+nut
upalungaiyautikhainut	u+pa+(lungaiya)+utikh+ai+nut
anikhaqtariamini	a+ni+kh+(aqtariami)+ni
uingaiqtuq	ui+nga+(i)+qtuq
tungauttuq	tung+a+(u)+tt+uq
qaqquqtuqtuq	qa+q+qu+(qtu)+qtuq
qiplarikhijuq	qi+p+la+(ri)+khi+juq
kakilahak	ka+kila+(ha)+k
imariktuq	ima+(ri)+kt+uq
taitaiphaaqtuq	t+a+itai+(pha)+a+qtuq
uqhuq	uqhu+(q)
amaamakhaq	a+(maama)+khaq
hiutik	(hi)+uti+k
taavani	ta+(av)+ani
pigliqtaqtuq	pi+(g)+liq+ta+qtuq
taimani	t+a+i+ma+(ni)
ukiuk	uk+i+(u)+k
inukkat	inu+(kk)+at
qirnariktuq	qi+rn+(ari)+kt+uq
iquutikhaut	i+qu+(utikha)+ut
pukkuk	pu+(kku)+k
mittaqtuqtuq	mi+(tt)+aqtu+qtuq
naalaut	na+(ala)+ut
uniaqtaa	un+(i)+a+qtaa
haluuqtuq	ha+(lu)+u+qtuq
tunihivaktut	tu+ni+(hi)+vak+tut
immautivuq	i+(mma)+uti+vuq
qalagjuarnirmit	qala+gjuarn+(irmi)+t
ublaigami	(ubla)+igami
atuugani	at+u+(u)+ga+ni
miyaupluni	mi+(ya)+up+lu+ni
nunalaangitni	nuna+(laa)+ngit+n+i
tagiuq	ta+(gi)+uq
uligaaq	(uli)+ga+aq
numiktirijuq	(numiktir)+i+j+uq
cam	ca+(m)
munagiplugit	mu+na+(g)+iplu+git
nakit qaivit	na+(kit )+qai+vit
nakujuq	na+(ku)+j+uq
kangiqhittiarumaguvit	ka+ngi+(q)+hi+ttia+ruma+gu+vit
tiguaqhiik	tig+(uaqhi)+ik
tuharnarnaqtuq	tu+ha+(rna)+rn+a+qtuq
pauttuq	pa+(u)+tt+uq
takujaa	ta+(ku)+jaa
ayungnautigivakhimayainik	a+yung+n+autig+(ivak)+hima+yai+nik
ihiviurnikkut	i+hiv+i+(ur)+nik+kut
ivgun	i+(vg)+un
aliahuktuq	a+(liahu)+kt+uq
itqarijaa	itq+(a)+rijaa
haamlatkunni	(haamla)+tk+un+ni
piutigiiyaat	pi+(utigiiya)+at
pualrit	pu+alri+(t)
takpiktuq	t+ak+(pi)+kt+uq
aupajangattuq	au+pa+j+ang+(a)+tt+uq
pamiqhihuktuq	pam+iqhi+(hu)+kt+uq
mahu	ma+(hu)
mamiahujuittuq	(mamiahu)+ju+ittuq
hamlatkut	ham+l+at+(k)+ut
aallatuqtuq	aall+a+(t)+u+qtuq
huqqaq	hu+(qq)+aq
ikkikhat	ikk+(ikha)+t
ikayuktiuyut	ik+ayu+(kti)+uyut
nivaktaa	ni+(va)+kt+a+a
qattaq	qa+t+(ta)+q
iepngitnik	(iep)+ngit+nik
qanilrumi	qa+ni+(lru)+mi
arjakhaq	arja+(khaq)
paamnguqtuq	pa+(amng)+u+qtuq
ipiutaq	ip+(i)+ut+aq
uqarrni	uqa+(r)+r+ni
atuqtipkaivakhunilu	at+uqt+(ipka)+i+vak+hu+nilu
nakuugilluanngitaa	nakuu+(gillua)+nng+i+taa
imiktautit	im+(iktautit)
pitiktaaqhuni	pi+ti+k+(ta)+aqhu+ni
aluktaa	a+(lu)+kt+a+a
hivuqqamut	hiv+(uqqam)+ut
pinahuaruti	pi+nahu+ar+u+(ti)
qipingajuq	qi+(pi)+nga+juq
angirunmik	ang+ir+(un)+mik
qiqailruq	qi+qai+(lru)+q
angutituqtuq	ang+(utit)+u+qtuq
nikhik	ni+(khi)+k
nippaqtuq	n+ip+(pa)+qtuq
uuktuutitikhanut	uuk+tu+(utit)+ik+ha+nut
anarvik	a+(na)+rvik
auktuqtaqtuq	auk+(tuqt)+a+qtuq
tikiutingitkumi	t+iki+(uti)+ngit+ku+mi
apquhiuqtuq	ap+qu+(hi)+u+qtuq
iggiaq	ig+(gi)+aq
ikpataujaq	ikp+(ata)+uja+q
mamarijaa	ma+(ma)+rijaa
taimna	ta+(i)+mna
havaktiqaqtunut	hav+akt+(iq)+aqtu+nut
aannuraariiqtuq	a+an+n+(uraarii)+qtuq
igluqpautainik	igluqpa+(uta)+i+nik
niuvrutikhaliqiyitkut	niuvr+(utikha)+liq+iyit+kut
tiguaq	tig+(u)+aq
iqalukpik	iqa+luk+(pi)+k
amihunik	a+mi+(hu)+nik
kihimngiuqtuq	kihimng+i+(u)+qtuq
kuvijaa	ku+(vi)+jaa
amauti	a+(ma)+uti
tamaanni	t+ama+(an)+ni
anngut	a+(nngu)+t
nuvuk	nuvu+(k)
kangiqliniqmi	ka+ngi+(qliniq)+mi
inugiakpallarami	inu+(gia)+kpall+arami
aulapkaidjutingit	aula+pka+(idjut)+i+ngit
pitquhiqtuqtuq	pit+q+uhi+(qtu)+qtuq
katimajiralaangit	kat+ima+(jirala)+a+ngit
akurun	ak+u+(r)+un
auktuqtuq	auk+(t)+u+qtuq
iqalukhiuqtuq	iqa+luk+(hi)+u+qtuq
igluaq	(iglu)+aq
tatqiq	ta+(tqi)+q
akuruti	ak+u+(r)+uti
tii	ti+(i)
pukkuq	pu+(kk)+uq
takkarjuaq	t+ak+(karju)+aq
piqaqtukhauyutin	pi+(q)+aqtu+kha+u+yut+in
ihumakittuq	i+hum+(a)+k+ittuq
iigluktuq	i+(iglu)+kt+uq
nangiaqtuq	na+(ngi)+a+qtuq
naunaiktauyukhat	naun+ai+(ktau)+yu+khat
higjaaq	hi+(gja)+aq
ihuagiyaungitunik	i+hu+(agiya)+u+ngit+u+nik
sar	(sar)
mikijuugaluamik	miki+(juuga)+lu+a+mik
pinahuaqhutik	pinahu+a+(q)+hu+tik
natiruvik	natir+uv+(i)+k
ihaqquk	i+haq+(qu)+k
iglukpaliurnikkut	igl+ukp+a+(liur)+nik+kut
ilviuguvit	il+(vi)+u+guvit
hivuniq	hivun+(i)+q
qin’nguti	qin+’ng+(uti)
tammaijaa	ta+(mma)+i+jaa
iqquk	iq+(q)+uk
nivrallaqhuni	ni+(vrall)+aqhu+ni
tulimaangit	tu+(lima)+a+ngit
nakuuginngitaa	nakuu+(gi)+nng+i+taa
angak	a+(nga)+k
nunguttuq	nu+(ngu)+tt+uq
tuquraliqqut	tu+q+(ura)+liq+qut
iqingajuq	iq+(i)+nga+juq
tiituqtuq	ti+(it)+u+qtuq
qaritauyaliqinikkutlu	qa+r+it+auyal+iq+(i)+nik+kut+lu
nauttiaq	na+(utti)+aq
hanalirumik	ha+(na)+liru+mik
atiqujaanga	at+i+qu+(jaa)+ng+a
ulukhaqtuumi	u+lu+(khaqtuu)+mi
aulayut	a+(ula)+yut
aihiqtuq	a+(ihi)+qtuq
ilauti	il+au+(ti)
tuktu	tu+(ktu)
tahinnuaq	ta+hi+(nnu)+aq
pirittaaqtuq	pi+(rit)+taa+qtuq
tunihimaaqtun	tu+ni+(hima)+aqtun
aturutikhani	a+tur+(utikha)+ni
ivalukhaun	(ivalu)+kha+un
malikhautikharnik	mal+i+(kha)+utikh+ar+nik
qupanuaq	qu+pa+nu+(a)+q
uquiqtuq	(uqu)+i+qtuq
uvajuq	(uva)+j+uq
aqiattuqtuq	aq+ia+(ttu)+qtuq
apqun	ap+(q)+un
ivujuq	i+(v)+u+juq
maniliqiji	man+ili+q+(i)+ji
akutuq	ak+u+(tu)+q
nutiplik	nu+(tip)+lik
mittuq	(mi)+tt+uq
pamiuq	pa+mi+(u)+q
ikajuqti	ik+a+(ju)+qti
pihugumaliqqut	pi+hu+(guma)+liq+qut
kanivauti	ka+(niva)+uti
quppirun	qu+pp+(ir)+un
uuktuqtuq	uuk+tu+(qtu)+q
pivikhaqautit	pi+(vikhaqauti)+t
iungnut	i+(ung)+nut
atuqtaungitlu	at+u+(qtau)+ngit+lu
hilaluktuq	hila+(lu)+kt+uq
kituliqaak	ki+(tu)+liq+a+ak
hiulliuqtuq	hi+(ulli)+u+qtuq
nunani	nuna+(ni)
upin’raaq	u+p+i+(n’ra)+aq
angitigijuq	ang+(itig)+i+j+uq
ihiviuqnikkut	i+hiv+i+(uq)+nik+kut
uuktuqtaa	uuk+t+(u)+qtaa
akhuuqhaiyukharniklu	ak+hu+(uqhai)+yukh+ar+nik+lu
hivajaut	hiv+aj+(a)+ut
katimayiingit	kat+ima+(yii)+ngit
havakhimayut	hav+a+(k)+hima+yut
qaqhuk	qa+(qhu)+k
apittuq	a+(pi)+tt+uq
palvitujuq	pa+lvi+(tu)+j+uq
haamirut	ha+(amir)+ut
ikittaaqtuq	ik+it+t+(a)+a+qtuq
tariuqhiuj	tari+(uqhi)+u+j
maamakhaq	(maama)+khaq
uvanilu	(uva)+nilu
uunaqutinik	uun+(aq)+uti+nik
nalaumajuq	na+(lauma)+j+uq
tuktuvak	t+uk+(tuva)+k
itqaumalutin	itq+a+(u)+ma+lutin
hilamiittuq	hila+(mi)+ittuq
kaaliqpallialiqqut	ka+al+i+(qpallia)+liq+qut
niriniaqtuq	niri+(ni)+a+qtuq
uluaraqtuq	u+lu+(ar)+a+qtuq
aqupliqtuq	a+qu+p+(li)+qtuq
ikhiq	i+(khi)+q
tuugaaq	tu+(u)+ga+aq
kakilahaijuq	ka+kila+(ha)+i+j+uq
uniq	(u)+niq
anuraiqtuq	a+nur+(a)+i+qtuq
ihuaqyumirutikharnik	i+hu+(aqyumi)+r+utikh+ar+nik
ikaaqtaa	ik+a+(a)+qtaa
havagviannin	hav+a+gv+(i)+anni+n
kivanmun	kiv+(an)+m+un
ivjaruhiqtuqtaa	ivj+ar+(uhi)+qtuq+taa
titirauhiat	titir+a+(uhi)+at
ikayuutauyuq	ik+ayu+(uta)+u+yuq
ilauyukhat	i+la+(u)+yu+khat
ivik	(ivi)+k
angun	a+(ng)+un
tuqulrajaqtuq	tu+(qulraja)+qtuq
nappaqtiqnikkut	na+pp+aqt+(iq)+nik+kut
navruaqhugu	na+v+(ruaqhu)+gu
qakuguliqaak	qa+ku+(gu)+liq+a+ak
havaktitirnirmun	hav+akt+(itir)+ni+rmun
piksaliun	pi+(ksaliu)+n
aittuuti	a+(ittu)+uti
amigaitunik	amig+a+(i)+tu+nik
tipaattuq	tip+(aa)+tt+uq
inuinnarnik	inuinna+(r)+nik
igitaa	i+(gi)+taa
ikkikhati	ikk+(ikha)+ti
inuujaq	inu+(uj)+aq
ukuat	u+ku+(a)+t
ungahitqiaq	ung+a+(hitqia)+q
uplaaq	u+pl+(a)+aq
attak	att+(a)+k
qunmuujuq	qu+n+mu+(u)+j+uq
akuliak	ak+u+(li)+ak
haamlangat	(haamla)+ng+at
ilunngunaqtuq	ilu+(nngun)+a+qtuq
akiliqhugit	ak+ili+(q)+hu+git
nivrallarvimingni	ni+(vrall)+arvi+mi+ngni
arnaqhiut	arna+(qhi)+ut
tarjuliqtuqtaa	t+ar+j+(uli)+qtuq+taa
iliffi	ili+(ffi)
qanakhatitigut	qan+(akha)+tit+igut
ublumittauq	ub+lu+(m)+it+ta+uq
mittimatalik	mi+(ttimata)+lik
uilgahuk	u+(ilgah)+uk
ilanatlu	i+la+(na)+tlu
ilaut	i+la+(u)+t
hivituyumut	hiv+(ituyu)+mut
inutuqqak	inu+tu+q+qa+(k)
nagjuk	na+(gju)+k
iliraidjutikhanik	ilira+(i)+djut+ikha+nik
kapuuti	ka+pu+(uti)
aunaaruiqtuq	au+naar+(u)+i+qtuq
qaffiuyukharnik	qa+(ffiu)+yu+khar+nik
tamuqtaa	ta+(mu)+qtaa
taivagaat	ta+i+(vaga)+at
tulimaaq	tu+li+(ma)+aq
pattaaqtaa	p+at+(taa)+qtaa
ayuiqhaqhimaanginaqtunik	ayu+iq+ha+q+(himaangin)+aqtu+nik
hingik	hi+n+(g)+ik
nakuyunga	na+(k)+uyu+nga
kangiqhijuq	kang+iqhi+(ju)+q
nujuittuq	nu+(ju)+ittuq
arnakhaq	arna+(khaq)
apqutailiutaujuq	apq+uta+ili+(uta)+u+juq
aktuqtauhimajut	ak+tu+(qtau)+hima+jut
aqiaruijaijuq	a+qi+aru+(ija)+i+j+uq
katimannangni	kat+ima+(nna)+ngni
management	ma+(nagemen)+t
puujjuk	pu+u+(jju)+k
qikiqtani	qi+kiqta+(ni)
maliqayauyut	mal+i+(qa)+y+auyut
quaqhalaaruti	qu+aq+ha+la+(a)+ruti
kiiliqtaa	ki+(ili)+qtaa
takimun	t+ak+(i)+m+un
mannik	man+ni+(k)
ikitaqtuq	ik+(ita)+qtuq
qikiqtaqtuurlu	qi+kiqta+(qtu)+ur+lu
kadlun	ka+(dl)+un
kigaqtuq	ki+(ga)+qtuq
munakhiyukhat	mu+na+(khi)+yu+khat
havaktunik	hav+a+(ktu)+nik
amaruaq	ama+(ru)+aq
maamak	(maama)+k
naluktuq	na+lu+(ktu)+q
imiqtaun	(imiqta)+un
aukhittiaqhimaittuq	auk+(hittiaq)+hima+ittuq
ihuarijamingnit	i+hu+(arijami)+ngni+t
qablunaavjak	qa+blu+(naavjak)
tupilak	tu+p+(ila)+k
kauttuarmiutarijaa	ka+uttu+(armiuta)+rijaa
aliqakhaq	aliq+(a)+khaq
ajuittuq	(aju)+ittuq
tuktuttuq	tu+(ktu)+tt+uq
taapkua	t+a+a+p+(ku)+a
havakvikyuangit	hav+ak+(vikyu)+a+ngit
pimmarighautikhanik	pi+(mmari)+gha+ut+ikha+nik
anmut	(an)+mut
hunat	hu+(na)+t
kiattik	ki+(at)+tik
ayuittiaqhimayut	ayu+it+ti+a+(q)+hima+yut
takupkaqtittailinikkut	takupka+qt+i+ttai+(li)+nik+kut
qamnguinnaqtuq	qamngu+(inn)+a+qtuq
qumaq	qu+(m)+aq
aanniaqtailiqinikkut	a+anni+(aqtai)+liq+inikk+ut
amrit	a+(mri)+t
niqikhaqtaa	ni+q+(ikha)+qtaa
quaqtaq	qu+(aqta)+q
alilaaqtuq	al+i+(la)+a+qtuq
taaksiiyaqtitaugutit	ta+ak+si+(iyaqtitaug)+uti+t
naammajjavuhi	naamma+jj+av+(uhi)
nipitairut	ni+pit+(air)+ut
tuhaqtuq	tu+(ha)+qtuq
niqait	ni+(qa)+it
uittuq	(u)+ittuq
iglaqtuq	igl+(a)+qtuq
qunguhiniq	qu+ng+u+(hi)+niq
aittiijuq	a+(itti)+i+j+uq
atqit	a+(tqi)+t
ikpat	ikp+(a)+t
nanminiriyauyut	na+nmin+(iri)+y+auyut
ipu	ip+(u)
iniqtuq	i+(ni)+qtuq
mamittuq	ma+(mi)+tt+uq
plutik	(p)+lutik
aulaaqatigikharnik	aula+a+(qatigi)+khar+nik
havaktikharnik	hav+akt+(i)+khar+nik
kavamatkunnilu	ka+(vama)+tk+unni+lu
nungulaaq	nu+(ngu)+laaq
imunik	i+(mu)+nik
uqautiukharnik	uq+a+ut+i+(u)+khar+nik
aannialiqtailitikhaptingnik	a+an+n+(ialiqtailit)+ikha+pting+nik
havagiarniaqpunga	hav+a+(giar)+ni+aq+punga
inuk	(i)+nuk
ilatit	i+la+(t)+it
kumiktuq	ku+(mi)+kt+uq
quvianaittuq	qu+vi+(ana)+ittuq
nangirvigijaa	na+ngi+(rvi)+gijaa
nibliqtuq	ni+(bli)+qtuq
qalakhuqtun	qa+l+(akhuqt)+un
nigaqtaa	ni+g+(a)+qtaa
niqitualgit	niq+i+(tualg)+it
nirijaa	(ni)+rijaa
puvalajuq	p+uv+(ala)+j+uq
tipi	tip+(i)
putuguq	pu+tu+(gu)+q
aullaqtinnagu	a+ull+aq+(tinna)+gu
atanguyangit	at+a+(nguya)+ngit
attautimut	att+a+(uti)+mut
aulatitivakhimayut	aula+tit+(ivak)+hima+yut
imarmiutanik	im+(armiuta)+nik
kitkuk	ki+(tku)+k
piksasuurvik	pi+(ksasuu)+rvik
tuutaujaq	tu+(uta)+uja+q
havakviuyuq	hav+ak+(vi)+u+yuq
pivikhaqautikhaniklu	pivikh+a+(qa)+utikh+a+nik+lu
imitqutailaq	i+mitqu+ta+(ilaq)
ikayukhuni	ik+ayu+(khu)+ni
kappiagijaa	ka+p+pi+a+(gi)+jaa
avguqtaa	av+guqta+(a)
akiingit	a+(ki)+i+ngit
munariyanginik	mu+na+(riya)+ngi+nik
takulugit	ta+(ku)+lu+git
hiquqtaa	hi+(qu)+qtaa
frolictunik	fr+(olic)+tu+nik
munagiyakhait	munag+i+(yakha)+it
aulatitiyut	aula+tit+(i)+yut
nayugaangani	na+(yugaa)+ng+a+ni
papiruq	pa+(pi)+r+uq
ilittturipkainikkut	ilit+t+tur+(ipka)+inikk+ut
qajangnaitkutikhat	qa+j+ang+na+it+(k)+utikh+at
hivumun	hiv+(u)+m+un
uqquuqun	uq+qu+(uqu)+n
aulaligaiguvitlu	aula+(li)+gai+guvit+lu
hivuraani	hiv+ur+(a)+ani
margo	ma+(rgo)
ikittaun	ik+it+t+(a)+un
pilaktuq	pi+(la)+kt+uq
aulatitiyaangat	aula+tit+(i)+yaang+at
paan’ruliaq	pa+an’r+(uli)+aq
hivulliurutikhainni	hivul+li+(uruti)+kha+in+ni
tatqiqhiun	tat+q+iqhi+(un)
aujijuq	a+(uji)+j+uq
niuviqtittiyut	ni+uv+i+(qtitti)+yut
ihumaliurutikhanik	i+hu+(maliur)+utikh+a+nik
naunaiyaqtauvaktut	naun+a+iya+(qtau)+vak+tut
maniliqidjutikharnik	man+ili+q+(i)+dj+utikh+ar+nik
hapkua	ha+p+(kua)
havangtinnahi	hav+ang+(tinna)+hi
najugani	na+(ju)+ga+ni
tikitinnanuk	t+iki+(tinna)+nuk
avataaqtaqtut	(avataaqt)+aqtu+t
pihuuyarniq	pi+hu+(uya)+r+niq
iqalukhiun	iqa+luk+(hi)+un
polarbearcub	polar+(be)+arcub
irmiut	(irmi)+ut
qin’ngaun	qin+’ng+(a)+un
havakluni	hav+ak+(lu)+ni
titiraun	tit+(ira)+un
nunallaanut	nuna+(lla)+a+nut
aput	a+(p)+ut
kaimalluriktuq	ka+i+mal+(luri)+kt+uq
amigakhuutiqaguvitluuniit	amig+ak+hu+(utiqa)+guvit+lu+uniit
atannguyauyunut	a+t+an+(nguya)+uyu+nut
havaatigullu	hav+a+(at)+ig+ullu
inuujuq	inu+(u)+j+uq
immaqaak	imma+qa+(a)+k
hakugiittuq	haku+(gi)+ittuq
apiqhuivik	ap+iq+(hu)+iv+ik
uqauhia	uqa+(uhi)+a
kinnguqtaa	ki+(nngu)+qtaa
tilarrin	ti+(larri)+n
kiguhiqqut	ki+guhi+(qq)+ut
munagiplugitlu	mu+na+(g)+iplu+git+lu
aliiquhiqtuq	a+(liiquhi)+qtuq
niuvrutiqariangani	niuvr+(utiqaria)+ng+a+ni
kapuraun	ka+pu+(ra)+un
nipiliurut	n+ip+(iliur)+ut
atugakhanik	at+u+(ga)+k+ha+nik
uqhuqtuuplu	uqhu+(qtu)+up+lu
qurluqtuq	qu+(rlu)+qtuq
uplumi	(uplu)+mi
akilikhihimaittumik	ak+ili+(khi)+hima+it+tu+mik
kiguti	ki+(g)+uti
tamaptik	t+ama+(p)+tik
uutiqtittuq	u+(utiqt)+ittuq
itipjaaqtuk	(itipjaa)+qtuk
aqaguani	aqag+u+(a)+ni
quanaqqutik	quana+qq+(u)+tik
attiqtuijuq	att+(iqtu)+i+j+uq
ilihaqtaa	ili+(ha)+qtaa
ajanikittuq	ajan+(i)+k+ittuq
ilupaaq	ilu+(pa)+aq
katimayiini	kat+ima+(yii)+ni
uqittuq	u+(q)+ittuq
atuaqtaut	at+u+(aqta)+ut
aanniaqtailiniq	a+anni+a+(qtaili)+niq
angilraujuq	angil+ra+(u)+j+uq
apqutiniktaa	apq+ut+(i)+nik+taa
upalungiarutikharnik	up+a+lu+ng+(ia)+r+utikh+ar+nik
aittuqtuijuq	a+ittu+(qtu)+i+j+uq
amigaqhuutikharnik	amig+aq+hu+(uti)+khar+nik
nangutaa	nang+(u)+taa
aluq	a+(lu)+q
qin’ngauti	qin+’ng+(a)+uti
anguun	ang+(u)+un
auktuqtaaqtuq	auk+(tuq)+taa+qtuq
ikayurniq	ik+ayu+(r)+niq
qinmiqpak	qin+mi+(qpa)+k
aaquaq	a+(aqu)+aq
affaqpallaijuq	affaqpa+(lla)+i+j+uq
nipikhauti	n+ip+(ikha)+uti
tulugaq	tu+(lu)+gaq
iliptik	ili+(p)+tik
kaugvik	ka+(u)+gv+ik
angijuq	an+(g)+i+j+uq
ilagiyat	i+la+(giya)+t
kinauvin	ki+na+u+(vi)+n
aittauqtuq	a+(itta)+u+qtuq
hilaluk	hila+(lu)+k
munakhidjutikhaniklu	mu+na+(khi)+djut+ikha+nik+lu
kitu	ki+(tu)
pimmarluktuq	pi+(mmarlu)+kt+uq
tuhaajaa	tu+ha+(a)+jaa
ayungnautigivakhimayaini	a+yung+n+autig+(ivak)+hima+yai+ni
higaarjuaq	hig+aa+(rju)+aq
nujait	nu+(ja)+it
anguniajuktuq	a+ng+un+i+(aju)+kt+uq
himmautaulakhimayuq	h+imma+(utaula)+kh+ima+yuq
qilluq	qi+(lluq)
tamaannut	t+ama+(an)+nut
pinahuaurutinun	pinahu+a+(uruti)+n+un
unnuktuq	(unnu)+kt+uq
kimikatiqaqqin	ki+(mik)+a+tiqaq+qin
nattiq	na+(tti)+q
itqakhaijuq	itq+(akha)+i+j+uq
ikhun	ik+(hu)+n
kiujaa	ki+(u)+jaa
tamarmik	t+ama+(r)+mik
imaittuq	ima+(i)+tt+uq
agiaqtaa	a+(giaq)+taa
amiiqtuq	a+(mi)+i+qtuq
hinaaqhijuq	hi+na+(aqhi)+j+uq
tamapta	t+ama+(pta)
havgut	hav+(g)+ut
hulidjutinun	huli+(djuti)+n+un
alianaittuq	al+ia+na+(ittu)+q
humiutauvit	hu+mi+(utauvi)+t
havilqhaq	hav+il+(qha)+q
inuillu	inu+(i)+llu
kingulliq	king+ul+(li)+q
nagluqitaqtuq	na+(gluqit)+a+qtuq
hanmijuq	h+an+(m)+i+j+uq
ilayunik	(ila)+yu+nik
tatilgaq	tat+(ilga)+q
makpiraq	makp+(ir)+aq
tunngavitkuni	tu+(nngavi)+tk+uni
una	(una)
amiraijaqtaa	a+mir+(aija)+qtaa
angajugiik	ang+aju+(gi)+ik
patautuqtuq	pa+ta+(ut)+u+qtuq
titiraakhaq	titir+a+(a)+khaq
ikayuqtaunahuaqtumut	ik+ayu+qtau+(nahu)+aqtu+mut
uvva	(uvva)
paaqtaa	pa+(a)+qtaa
malrunnguqtait	malru+(nnguq)+t+a+it
piumaluaqtaingitlu	pi+uma+(lu)+aqt+ai+ngit+lu
gnkutni	(gnkut)+ni
kapittuq	ka+(pi)+tt+uq
tariurnittuq	tari+(urn)+ittuq
anuqhilaqiliqtuq	a+nu+q+h+(ilaqi)+li+qtuq
qulviliuqtuq	qu+lvi+(li)+u+qtuq
nunaqyuaptingnik	nuna+(qyua)+pting+nik
inikhaqquqtujuq	inikhaq+qu+(qtu)+j+uq
aijaahiqtuq	aija+a+(hi)+qtuq
tatqiqhiutini	tat+q+iqhi+(uti)+ni
auguiqtuq	a+u+(gu)+i+qtuq
nuutaa	nu+(u)+taa
ukkuiqtuq	u+(kku)+i+qtuq
hulijakhaqhiuqtuq	huli+(jakhaqhi)+u+qtuq
uvattiaguttauq	uv+attia+(guttauq)
taimunga	ta+i+(mu)+nga
naunaitkutikhainnik	na+una+it+(k)+utikh+a+in+nik
arviq	a+(rvi)+q
itqaqtuq	itq+(a)+qtuq
mitquti	mitqu+(ti)
aulatitilirman	aula+tit+(ili)+rma+n
kaapi	ka+ap+(i)
minihitauyuq	mi+ni+(hita)+u+yuq
hivurallak	hiv+ur+(alla)+k
haamirun	ha+(amir)+un
qaatiqtuq	qa+a+(ti)+qtuq
havakti	hav+akt+(i)
titiraliqinikkut	titir+a+(liq)+inikk+ut
unnuliqtuq	u+(nnu)+li+qtuq
taihittiarutighainni	ta+(ihi)+ttia+ruti+gha+in+ni
qanuriliuruhiit	qa+nur+(iliur)+uhi+it
qaptiruti	qa+p+(tir)+uti
paijuq	pa+(i)+j+uq
qin’ngun	qin+’ng+(un)
ipua	ip+(ua)
anautaq	a+(na)+ut+aq
taimuuna	ta+i+(mu)+un+a
inirnikhangutiptingnik	ini+(rni)+kha+ng+uti+pting+nik
ikayuutikhatlu	ik+ayu+(utikha)+tlu
ippakhat	(ippa)+khat
haamlauyumi	(haamla)+u+yumi
nipiliut	n+ip+(ili)+ut
quviahugvik	quviahu+(g)+vi+k
panituaq	pa+ni+(tu)+aq
havakpakhutik	hav+a+(kpak)+hu+tik
tarrijauti	(tarrija)+uti
qiniqhialiqiyut	qin+iqhi+(a)+liq+iyut
akiliqtaullayut	ak+ili+(qtaulla)+yut
hilami	hi+(la)+mi
hulilukaavikhanik	huli+lu+ka+(avi)+k+ha+nik
ipikhaijuq	ip+(ikha)+i+j+uq
kivgaqtuiplutik	kivgaq+tu+(i)+plu+tik
angullu	ang+(u)+llu
piquyatlu	pi+(quya)+tlu
jeannie	j+e+anni+(e)
akimahuqtuq	aki+ma+(hu)+qtuq
aallanngutiriumagumik	aall+a+(nngutiriuma)+gu+mik
akituvallaaqtuq	a+ki+tu+vall+(a)+a+qtuq
numiktittitdjutingit	nu+(mik)+tit+tit+djut+in+git
akihaqtuq	aki+(ha)+qtuq
aumajuq	(auma)+j+uq
aik	a+(i)+k
atanguyaliqinikkut	at+a+(nguya)+liq+inikk+ut
paappak	pa+(appa)+k
ittuaqtuq	(ittu)+a+qtuq
aittuuhiaq	a+ittu+(uhi)+aq
akhunaaq	ak+hu+(na)+aq
kuvjaqtuqtuq	ku+vj+(aqtu)+qtuq
qaangani	qa+(a)+ng+a+ni
igluittuq	i+(glu)+ittuq
avatitigut	av+at+(itig)+ut
hiqquqtijjuti	hiqquqti+jj+(uti)
illiqpik	i+ll+(iqpi)+k
kanatam	ka+na+(tam)
qigliriaqtuq	qi+(gliri)+a+qtuq
ukiunga	ukiung+(a)
upalungaiyadjavutit	up+a+lu+ng+(aiyadjav)+uti+t
inmikkut	in+mikk+(ut)
nipiliun	n+ip+(ili)+un
hivulliutiyukhanutaullapkiatjutit	hivul+li+(uti)+yukh+anut+aullapki+at+jut+it
help	(help)
ukkuaq	(ukku)+aq
itkiq	i+(tki)+q
atirluaqtuq	at+(irlu)+a+qtuq
piqpagijaa	pi+(qpa)+gijaa
aulatjutititgut	aula+t+j+ut+(ititg)+ut
angulalik	ang+u+(la)+lik
ikkikhan	ikk+(ikha)+n
malruuk	malru+(u)+k
minista	mi+ni+(sta)
harnum	ha+(rnum)
hunauvva	hu+na+(uvva)
uniaqti	un+(i)+a+qti
aitugianganik	a+i+tu+(gianga)+nik
hilviaq	hi+(lvi)+aq
akirarijaa	aki+ra+(r)+i+jaa
piniqqak	pi+(ni)+q+q+ak
ihumagij	i+hum+(a)+gij
tiuqtiuqtuq	ti+(uqti)+u+qtuq
humunngauliqqin	hum+unng+(auliqq)+in
tatpikani	tat+(pik)+ani
ajakutaaq	a+(jakutaa)+q
ungullaut	ungul+l+(a)+ut
ilauyullu	il+au+(yu)+llu
hamna	(ha)+mna
kingiktum	kingik+tu+(m)
nappaqtirnikkullu	na+pp+aqt+(ir)+nik+kul+lu
paanariplugit	pa+(anar)+iplu+git
qangiaq	qa+(ngia)+q
kakkiijaun	ka+(kkiija)+un
kennethlu	(kennethlu)
ikpingnarniq	ik+pi+(ngna)+r+niq
taaksiyaungittuq	ta+ak+si+(yau)+ng+ittuq
iqqakuurut	iqqaku+u+(r)+ut
aiktaqtuq	a+(i)+kta+qtuq
amigaqhuutiqaqqan	amig+aq+hu+(utiqaq)+qa+n
unnukpat	(unnu)+kp+at
qaqhauq	qa+(qha)+uq
umiarmi	(umi)+armi
maligaliqiryuarvingmi	mal+ig+aliq+(iryua)+rvi+ngmi
havakhimaanginaqtun	hav+ak+(himaangin)+aqtun
akulliqut	(akulliq)+ut
iqitaa	iq+(i)+taa
kivgaq	kiv+(g)+aq
navvannguqtuq	na+v+(vanng)+u+qtuq
uvamnik	uva+(m)+nik
niujjivik	ni+(ujj)+iv+ik
igluqpaitigut	igluqpa+(itig)+ut
amigaikyumiyangini	amig+a+(ikyumiy)+angi+ni
annaktuiyuliqiyutlu	annaktui+(yuliq)+iyut+lu
kangiqhimanngittuq	kang+iqhi+(ma)+nng+ittuq
muqpak	(muqpa)+k
pulgiq	pu+(lgi)+q
ipulvik	ip+(u)+lvik
pihimayunik	(pi)+hima+yu+nik
ehaloak	(ehaloa)+k
maamaut	(maama)+ut
ajuiqharvikhait	aju+(iqhar)+vi+kha+it
uanmun	u+(an)+m+un
havaktiqaqtut	hav+akt+(iq)+aqtu+t
tuquttuk	t+uq+ut+(tu)+k
ihumangnik	i+hum+(a)+ng+nik
pingujaa	pi+(ngu)+jaa
tivjaqtaqtuq	t+ivj+(aqta)+qtuq
ihumaliurutinga	i+hu+(maliur)+uti+nga
ijjuaqhijuq	ijju+(aqhi)+j+uq
akiraq	aki+ra+(q)
piannarviillu	pi+anna+(rvi)+il+lu
haumik	ha+(u)+mik
tiriajaaq	tiri+(aja)+aq
ayuittiarutikharnik	ayu+it+ti+a+(r)+utikh+ar+nik
iqaluqarvik	iq+a+lu+(qarvi)+k
aullaqtinnanga	a+ull+aq+(tinna)+nga
titiqqanik	titiq+(qa)+nik
tunigiami	tu+ni+(gi)+a+mi
haunittiariik	haunitti+(ariik)
aullapkaidjutingnikhavagviat	a+ulla+pka+(idjut)+ingn+ikhava+gv+i+at
aingittuq	a+(i)+ng+ittuq
inuinangnik	inu+i+(na)+ng+nik
qinngaqtuq	qi+(nng)+a+qtuq
kaasiliiqtuqtunik	ka+(asilii)+qtuq+tu+nik
nanminikharnik	na+nmin+(i)+khar+nik
hinmiutaq	hi+n+(mi)+ut+aq
iqalliqijut	iq+al+(liqi)+jut
quanaqpiaqqutit	quana+qpi+(aqq)+uti+t
maniliqiyiryuakkut	man+ili+q+(iyi)+ryua+kkut
tammariikkutimik	ta+(mmari)+ikkut+i+mik
hakhaluutit	ha+(khalu)+uti+t
ipiiqtuq	i+(pi)+i+qtuq
ivgut	i+(vg)+ut
haqiktuq	ha+(qi)+kt+uq
qattiniq	qa+(tti)+niq
umiaq	u+(mi)+aq
unaguiqhiqtuq	(unaguiqh)+i+qtuq
unalu	(una)+lu
aannuraangiqtuq	a+an+n+(uraang)+i+qtuq
ipiktuq	i+(pi)+kt+uq
huuq	(huu)+q
kuvijuq	ku+(vi)+j+uq
ningaqtut	ni+(ng)+aqtu+t
ivjaquti	ivj+(aq)+uti
pitjutikkut	pi+(tj)+ut+ikkut
tigumiaqtaa	(tigumia)+qtaa
qayangnairutikharnik	qa+(yangnai)+r+utikh+ar+nik
quagjuk	qu+(agju)+k
paun’raq	pa+u+(n’ra)+q
akhuninguraangat	akhun+i+ng+(uraang)+at
niuvirvik	ni+uv+i+(rvi)+k
havangnata	hav+ang+(na)+ta
pilaun	pi+(la)+un
hukatiruti	hu+ka+(tir)+uti
taqturun	taq+tur+(un)
uqautjiyiinilu	(uqautjiy)+iini+lu
angunnait	ang+u+(nna)+it
auladjutikharnik	aula+dj+ut+(i)+khar+nik
kanivaun	ka+(niva)+un
avguijuq	a+(vgu)+i+j+uq
havakviitanut	hav+ak+(viit)+anut
iqalungni	iq+a+lu+(ngni)
aqilummaaq	aqil+(ummaa)+q
nutaqqijuq	n+uta+(qq)+i+j+uq
kalluk	ka+(ll)+uk
akikhilakhugit	aki+kh+il+(ak)+hu+git
nukaun’nguq	nu+(kaun’ng)+uq
pinahuarutinik	pi+nahu+ar+u+(ti)+nik
tungullaktuq	tu+n+(gulla)+kt+uq
taanngaq	ta+(anng)+aq
iqairhainikkullu	iq+(airhai)+nik+kul+lu
aluuti	a+lu+(uti)
hitamat	(hitama)+t
aqilluqqaq	aqil+lu+(qq)+aq
hangiaktuq	ha+(ngia)+kt+uq
aajjikiiktuk	a+a+(jjik)+i+iktuk
ingniq	(i)+ng+niq
ilitturipkaitjutinik	ili+t+turip+ka+(itjut)+i+nik
ininiktaa	ini+(ni)+kt+a+a
munarigiami	mu+na+(rigi)+a+mi
niliqtuq	(ni)+li+qtuq
tuqutaa	t+uq+ut+(aa)
amigaqhuutiliqiyut	amig+aq+hu+(uti)+liq+iyut
atanikittuq	at+a+(ni)+k+ittuq
tahittaaqtuq	ta+h+(itta)+a+qtuq
piannaqatigijaa	pi+anna+(qatigi)+jaa
uluriahuktuq	uluri+a+(hu)+kt+uq
understand	under+(sta)+n+d
uujuq	u+(u)+j+uq
tunnuq	tu+n+(nu)+q
atani	a+t+an+(i)
algaijaqtuq	alg+(aija)+qtuq
ilakuq	i+la+(ku)+q
akiagut	aki+(ag)+ut
havaghaqhiuqtunun	hav+a+g+haq+hi+(uqtu)+n+un
aaktuq	a+(a)+kt+uq
havaktitiukharnik	hav+akt+(itiu)+khar+nik
nunallaat	nuna+(lla)+at
ajuqhavjaliqtuq	ajuq+ha+(vja)+li+qtuq
angatkuq	ang+a+(tku)+q
attik	a+(tti)+k
katitiqtauyukharnik	k+at+iti+(qtau)+yu+khar+nik
himmauhiktaa	h+imma+(uhi)+kt+a+a
ukaliq	uk+(ali)+q
qalingujuq	qa+li+ng+(u)+j+uq
aptunikittuq	aptu+ni+(ki)+tt+uq
hanayakhamingnik	ha+na+(yakha)+mi+ng+nik
hapun	ha+(p)+un
hainngiguhuktuq	hain+ngi+(guhu)+kt+uq
havakhimaaqpaktuq	hav+a+(khimaaqpa)+kt+uq
nakinpijat	na+(kinpij)+at
hiirnaqtuq	hi+(i)+rn+a+qtuq
hulijakhaq	huli+(ja)+khaq
ilaqatigiiktukharnik	i+la+(qatigi)+ik+tu+khar+nik
napariaq	na+(pari)+aq
anguniaqtuq	a+ng+un+i+(a)+qtuq
ubluanga	ub+lu+(a)+ng+a
hunamut	hu+na+(m)+ut
humin	hu+mi+(n)
talurjuaq	ta+lu+(rju)+aq
hiqquqtijjun	hiqquqti+jj+(un)
arvinik	a+(rvi)+nik
nutaangutqiyauyuniklu	n+uta+a+ng+(utqi)+ya+uyu+nik+lu
hikunngiqtuq	h+iku+(nng)+i+qtuq
tupiqtuq	tu+p+(i)+qtuq
ihivriuqtaa	ihivr+i+(u)+qtaa
qamauktuqtuq	qa+(maukt)+u+qtuq
tukiliurutighaannik	t+uk+(iliur)+uti+gha+an+nik
qujajuq	qu+(ja)+j+uq
gn	(g)+n
takummarikhijaa	taku+(mmari)+khi+jaa
iqaluktuutiarmi	iqa+luk+(tuuti)+armi
aippaagu	(aippaa)+gu
nirlirnaq	ni+(rli)+rnaq
aqpahijuq	aqpa+(hi)+j+uq
havagvikyuangit	hav+a+gv+(ikyua)+ngit
utarujaq	ut+(ar)+uja+q
uplaigami	u+pl+(a)+igami
iqaluktinnagu	iqa+luk+(tinna)+gu
kakkiktuq	ka+k+(ki)+kt+uq
katudjiqatigiit	ka+tudji+(qatigi)+it
takuhunngujatit	taku+(hunnguja)+tit
mis	mi+(s)
aulatti	aula+(tti)
kamngit	ka+(m)+ngit
hivvuqtaa	hivv+(u)+qtaa
naluujauti	na+lu+(uja)+uti
ngatut	ng+(a)+tut
qagarami	qa+g+(ar)+a+mi
ikpiarjuk	ikp+(i)+ar+ju+k
qalingahuktun	qa+li+ng+(ahukt)+un
naunaitkutaq	na+una+it+(k)+ut+aq
kangiqhimaittuq	kang+iqhi+(ma)+ittuq
havaagilu	hav+a+(agi)+lu
puja	pu+(ja)
agiraq	a+(gi)+raq
qinngarnaqtuq	qi+(nnga)+rn+a+qtuq
nipi	n+ip+(i)
atqunaqtuq	(atqun)+a+qtuq
nunguqhuqtuq	nu+(nguqhu)+qtuq
mirharnikkut	mi+(rhar)+nik+kut
puvvak	p+uv+(va)+k
kiguhiqqun	ki+guhi+(qq)+un
qarliik	qa+(rli)+ik
ijjuaqtaa	i+(jju)+a+qtaa
naunaiyagiikhimaplutiklu	naun+a+iya+(giikhima)+p+lutik+lu
inilradjutikhangit	ini+(lradj)+utikh+a+ngit
uuktaun	uuk+t+(a)+un
hukattuq	hu+ka+(ttu)+q
tupikhaq	tu+p+(i)+khaq
titiraqhimajun	ti+tiraq+hi+ma+(j)+un
tingittuq	ti+(ngi)+tt+uq
qakunngurmat	qa+ku+(nngu)+rma+t
nigaqtuqtuq	ni+g+(aqtu)+qtuq
minguliruqtuq	mingul+(ir)+u+qtuq
taiguqtuq	ta+(igu)+qtuq
hiitquq	hi+itqu+(q)
inutuqqaliqijillu	inu+tu+q+qa+(liq)+iji+llu
inuittuq	inu+(i)+tt+uq
kijuaqtuqtuq	ki+(ju)+aqtu+qtuq
niuviqtuq	ni+uv+i+(qtu)+q
kigulliuqtuq	ki+gu+(lli)+u+qtuq
quinaktuq	qu+(ina)+kt+uq
imiqtaqtiuyut	(imiqta)+qti+u+yut
aullaqtinnagik	a+ull+aq+(tinna)+gik
nangariyauyuq	nang+(ariya)+u+yuq
naunaitkutikhanik	na+una+it+(k)+utikh+a+nik
qijuktaqtuq	qi+(ju)+kta+qtuq
tatqamunga	tat+qa+(mu)+nga
inikhaqqukittuq	inikhaq+qu+(ki)+tt+uq
kapuutikhatikhamik	ka+pu+(utikha)+t+ikha+mik
kuapigaq	ku+a+pi+(ga)+q
atuqtaulihaarutauniarami	at+uqtau+(lihaar)+utauni+arami
aannuraanik	a+an+n+(ura)+a+nik
aulanirmi	au+(la)+nir+mi
iliharnikkut	ili+ha+(r)+nik+kut
maligait	mal+i+(ga)+it
ni	(ni)
tarraqtuqtuq	ta+(rr)+aqtu+qtuq
upalungaiyautin	u+pa+(lungaiya)+ut+in
aajikkiikniqatunik	a+aj+ik+kiik+niq+(a)+tu+nik
iqhiqpak	iq+hi+(qpa)+k
pinguatigaq	pi+(nguati)+gaq
ikilik	ik+(ili)+k
munaqtiinut	mu+na+(qti)+in+ut
majuqqaq	ma+j+u+(qq)+aq
ajagutaaq	aj+agu+(ta)+aq
kaivittuq	ka+(ivi)+tt+uq
kangiryuarmiut	ka+ngi+(ryua)+rmiut
gwen	(gwe)+n
hii	hi+(i)
ikangnini	ik+a+(ngni)+ni
kan’nguhuktuq	k+an’ng+u+(hu)+kt+uq
dew	(dew)
kayumiktukkut	k+ayu+mi+(ktu)+kkut
hainngihuktuq	hain+ngi+(hu)+kt+uq
ivguti	i+(vg)+uti
kumak	k+uma+(k)
nakitqaivit	na+(kit)+qai+vit
nirlivik	ni+(rli)+vi+k
qaritaq	qa+(rit)+aq
iki	ik+(i)
hivuniptingni	hivun+(i)+pting+ni
ihivriurhiniit	ihivr+i+(urhi)+ni+it
nevada	n+(evad)+a
tuqhuaq	tuq+hu+(a)+q
kikturiaq	ki+k+tu+ri+(a)+q
ajaniqtujuq	ajan+(iqtu)+j+uq
pamirraaqtuq	pa+mi+(rra)+a+qtuq
havakpakhimayainik	hav+a+(kpak)+hima+yai+nik
kipijaa	ki+(pi)+jaa
taluquaq	t+al+(uqu)+aq
kuvjaq	ku+vj+(a)+q
iqqaqtuq	i+(qqa)+qtuq
ikayuqhugillu	ik+ayu+(qhu)+gi+llu
mitqukittuq	mi+(tqu)+k+ittuq
ahinni	a+hi+(n)+ni
ihaqutaq	i+haq+(ut)+aq
ivjuhiliqtuq	ivj+u+(hi)+li+qtuq
maningnik	ma+ni+(ng)+nik
arviqtuq	a+(rvi)+qtuq
akiliqtitilimaittut	aki+(liqtiti)+lima+it+tut
uingaiqtaa	ui+nga+(i)+qtaa
uluaqtaa	u+lu+(a)+qtaa
ahiruqtuq	a+hi+(r)+u+qtuq
aulaqatigiinarlutin	aula+(qatigi)+in+ar+lutin
uluaqtuqtaa	u+lu+(a)+qtuq+taa
qanuriliurutikhallu	qa+nur+(iliur)+ut+ikha+llu
taphi	ta+(phi)
hulivit	huli+(vi)+t
algalaq	alg+(alaq)
inukhaliqaliqtinnagillu	inu+kh+aliq+aliq+(tinna)+gi+llu
tikiq	ti+(ki)+q
akulrutaaqtuq	ak+u+(lru)+taa+qtuq
havagvingnun	hav+a+gv+(ing)+n+un
hukhamun	hu+(kha)+m+un
iqalukhiurviliaqtut	iqa+luk+(hiurvili)+aqtu+t
haulluut	ha+(ullu)+ut
kimmirut	ki+(mmir)+ut
qunmun	qu+n+mu+(n)
atiit	a+(ti)+it
aliqak	aliq+(a)+k
ukunangat	u+ku+(nang)+at
ikijuq	(ik)+i+j+uq
munagivagait	munag+i+(vaga)+it
niujaujuq	ni+u+(ja)+u+juq
hanaqidjutikhangitlu	ha+n+aq+idjut+(ikha)+ngit+lu
tugangayut	tu+(ga)+nga+yut
kikiaktaa	ki+ki+(a)+kt+a+a
uulijuq	u+(uli)+j+uq
ngutillugu	nguti+(llugu)
nakiqtuq	na+(ki)+qtuq
nirjun	ni+(rju)+n
munagiyukharnik	munag+i+(yu)+khar+nik
havaqati	hav+a+(qa)+ti
aulagahuaqin	aula+(ga)+huaq+in
huukiaq	hu+(uki)+aq
uqaujaq	uq+au+(ja)+q
hunanik	hu+(na)+nik
annaktuq	a+(nna)+kt+uq
talva	ta+lv+(a)
algiqtuq	alg+(i)+qtuq
ini	i+(ni)
laisikhaitigut	lais+(ikha)+it+igut
havik	(havi)+k
makpiga	makp+(i)+ga
hatqummiqtaa	ha+tqu+mmi+(q)+taa
akkiutaq	a+(kki)+ut+aq
aqhaktuq	(aqha)+kt+uq
higguqquqtujuq	higg+uq+qu+(qtu)+j+uq
ikhivautaq	ik+hiv+(a)+ut+aq
kivgaqtungnirmun	kivgaq+tu+(ng)+ni+rmun
upalungaidqhimajut	up+a+lu+ng+(aidq)+hima+jut
angiglijuq	angi+(gli)+j+uq
niqailliuqhutik	ni+q+(ailliuq)+hu+tik
nakin pijat	(nakin pij)+at
qinmiriaktuq	qin+mi+(ria)+kt+uq
nunallanut	nuna+(lla)+nut
qunmuudjuti	qu+n+mu+(udj)+uti
titiraqhimattumi	ti+tiraq+hi+ma+(ttu)+mi
tingmiaqhiuqtuq	tingmi+(aqhi)+u+qtuq
ihuaqhijaa	i+hu+(aqhi)+jaa
aturutitinik	a+tur+(utit)+i+nik
nakuuhijut	nakuu+(hi)+jut
aqublingajuq	aq+ub+(li)+nga+juq
hivvuqtuqtuq	hivv+(uqtu)+qtuq
ublunuamik	ub+lu+(nua)+mik
ikayuutikharniklu	ik+a+(yu)+utikh+ar+nik+lu
kipihimajuq	ki+(pi)+hi+majuq
ivgit	i+(vg)+it
iliarjuk	i+(li)+ar+ju+k
akuqtujuq	ak+u+(qtu)+j+uq
pinahuarutimit	pi+nahu+ar+u+(ti)+mit
mahik	ma+(hi)+k
ukujuq	u+(ku)+j+uq
taijaa	ta+(i)+jaa
ihuigiyaqaqtut	i+hu+(igiyaq)+aqtu+t
hanaqidjutikhangit	ha+n+aq+idjut+(ikha)+ngit
putuligaq	pu+tu+(li)+gaq
naunaiqtauhungujut	naun+ai+(qtauhung)+u+jut
takulugu	ta+(ku)+lu+gu
takuvakkaluaqhutik	taku+(vakkaluaq)+hu+tik
maligutainni	mal+i+(g)+utain+ni
nunaqaqhimajuq	nuna+(qaq)+hi+majuq
uvuuna	uv+(uuna)
uuktaut	uuk+t+(a)+ut
avikturniinni	av+ikt+u+(rni)+in+ni
namiitunga	(namiitu)+ng+a
akiliktakhainut	ak+ili+(ktakha)+in+ut
alappaa	a+(lappaa)
kuutiruq	ku+(uti)+r+uq
aluktuqtaa	a+lu+(ktu)+qtaa
iluviq	ilu+v+(i)+q
angajukhiqun	ang+aju+(khi)+q+un
apqutaiqtuq	apq+ut+(a)+i+qtuq
ikkiti	ik+(k)+i+ti
atauttimuktait	a+ta+utti+(muk)+t+a+it
atuqquyiyut	atuq+qu+(y)+iyut
pihujjarluktuq	pi+hu+(jjarlu)+kt+uq
ajurnaqtuq	a+(ju)+rn+a+qtuq
takiunniin	t+ak+(i)+unni+in
umialik	u+mi+(ali)+k
qiuk	q+(i)+uk
itiruq	i+(ti)+r+uq
hanaqittiaqtauyukhakkut	ha+na+(q)+ittia+qtau+yukh+ak+kut
ilauhimaanginaqpakhimayuq	il+au+(himaangin)+aq+p+akhima+yuq
pidjutigiyaqut	p+idjut+(igiyaq)+ut
minihitaq	mi+ni+(hi)+taq
ayuittullu	ayu+i+(t)+t+ullu
naluujaqtuq	na+(lu)+uja+qtuq
hunamun	hu+na+(m)+un
havagviata	hav+a+gv+(i)+at+a
pinahuaqtangit	pinahu+a+(qta)+ngit
tamuajuq	ta+(mua)+j+uq
hitujuq	hit+(u)+j+uq
ihumaliuqtuq	i+hum+(ali)+u+qtuq
nakin	na+(ki)+n
aappakhaq	a+(appa)+khaq
atqut	at+(q)+ut
ministauplunilu	m+inista+(uplu)+nilu
ilutujuq	ilu+(tu)+j+uq
itput	(itp)+ut
naunaikpakhutiklu	naun+ai+(kpak)+hu+tik+lu
igluliqiji	i+(glu)+liq+iji
hauvut	ha+(uv)+ut
aqumuktuq	(aqumu)+kt+uq
kamiktuq	ka+(mi)+kt+uq
hilataani	hila+(ta)+ani
kapurauti	ka+pu+(ra)+uti
titigaita	tit+(iga)+ita
inungnut	inu+(ng)+nut
irmiun	(irmi)+un
ikayuqtikhatlu	ik+ayu+(qti)+khat+lu
ihivriuqtiuyunik	ihivr+i+(uqti)+uyu+nik
nuutaani	(nu)+u+taa+ni
mikhijuq	(mi)+khi+juq
ihumagiplugit	i+hum+(ag)+iplu+git
naujaq	(na)+uja+q
havalik	hav+a+(li)+k
aniqtak	an+(iqta)+k
ilihaqtaunighakkullu	ili+ha+(qtau)+ni+g+hak+k+ullu
nunami	nuna+(mi)
imnaq	im+(na)+q
paatuliiq	pa+(atuli)+iq
hiquqtuq	hi+(q)+u+qtuq
hivajaqtaaqtuq	hiv+aj+(aqta)+a+qtuq
ikpakhaq	ikp+(akha)+q
inukhiarijaa	inu+(khia)+rijaa
kukukuulaq	(kukukuul)+aq
qimuktuq	qi+(mu)+kt+uq
titiraujaqtuq	titir+a+(uj)+a+qtuq
tunihimaaqhutik	tu+ni+(hima)+aqhu+tik
uiniq	(u)+in+iq
ttitirarvikhaq	(ttiti)+r+ar+vikhaq
havangtinnata	hav+ang+(tinna)+ta
aulaarnahuaqtailutin	aula+a+(rna)+huaq+tai+lutin
kataktaa	ka+(ta)+kt+a+a
tukhirutini	t+uk+(hir)+uti+ni
uqpik	(uqp)+ik
ilihaidjutit	ili+ha+(idj)+uti+t
titrauti	tit+(ra)+uti
hiurjuuti	hiurju+(u)+ti
pipkainikkut	pi+(pka)+inikk+ut
talimangani	ta+(lima)+ng+a+ni
ikayungniaqhugitlu	ik+ayu+(ngni)+aqhu+git+lu
kanatamlu	ka+na+(tam)+lu
maktaq	ma+(kt)+aq
atauhiinnaq	at+a+(uhi)+in+naq
aulapkaiviknik	aula+pka+(ivi)+k+nik
havakhimaaqpaktun	hav+a+(khimaaqpa)+kt+un
kuvjaqhuqtuq	ku+vj+(aqhu)+qtuq
itqiq	i+(tqi)+q
ingniquhiqiji	ing+niq+(uhiq)+ij+i
tatqiqhiuti	tat+q+iqhi+(uti)
qin’raun	qi+(n’ra)+un
aullaqtinnahi	a+ull+aq+(tinna)+hi
palviittuq	pa+lvi+(i)+tt+uq
utaqqijaa	utaqq+(i)+jaa
tunujaq	tu+n+(uj)+aq
munagihimayut	mu+na+(gi)+hima+yut
qanuq	qan+(u)+q
huli	hu+(li)
ukiijuq	uk+i+(i)+j+uq
aijaa	a+(i)+jaa
quana	qu+(ana)
apqut	ap+qu+(t)
imiqtauti	(imiqta)+uti
unuqtuq	(unu)+qtuq
nakuungitut	nakuu+(ngi)+tut
aphaqpallaijuq	ap+ha+qpa+(lla)+i+j+uq
nutaqqijaa	n+utaqq+(i)+jaa
pijumajaa	p+ij+u+(ma)+jaa
kuvjaqtaa	ku+vj+(a)+qtaa
nujaiqtuq	nu+(ja)+i+qtuq
aituqtauvakhimayuq	(aituqtau)+v+akhima+yuq
piksaliut	pi+(ksaliu)+t
aqiarurliuqtuq	a+qi+aru+(rli)+u+qtuq
qauqtaq	qa+(uq)+taq
hivajaqtuq	hiv+aj+(a)+qtuq
arnauniriik	arna+(uniri)+ik
tiiliuqtuq	ti+(ili)+u+qtuq
nikhaaktuq	ni+(khaa)+kt+uq
tallak	(ta)+llak
tikinnanuk	t+iki+(nna)+nuk
ulujjak	u+lu+(jja)+k
nigaqtuq	ni+g+(a)+qtuq
maliqatqujauhimajunut	mal+iq+atquja+u+(hima)+ju+nut
qitun’raq	qi+(tun’)+raq
ukiuqtuq	uk+i+(u)+qtuq
qaritauyakkurutani	qa+ritauya+(kkurut)+ani
aulattijuq	aula+(tti)+j+uq
puujjuktuq	pu+u+(jju)+kt+uq
ihuaqtumik	i+hu+(aqtu)+mik
upluq	(uplu)+q
qalluraqtiuyunutlu	qa+ll+(ura)+qti+uyu+nut+lu
inikhaittuq	ini+(kha)+ittuq
uuktuuquyauyut	uuk+tu+(uqu)+y+auyut
havvariktuq	hav+var+(i)+kt+uq
hivunikhanilu	hivun+(ikha)+nilu
qiuvik	qi+(u)+vi+k
qaujihaiji	q+auj+i+ha+(iji)
upluriaq	(uplu)+riaq
pilihaarnirmin	pi+(lihaar)+nir+mi+n
havakhimaaqtunik	hav+a+(k)+hima+aqtu+nik
atuqhutik	a+(tuq)+hu+tik
naittuq	na+(i)+tt+uq
nalrujuq	na+(lru)+j+uq
niruaqtauvakhimayuq	ni+r+(uaqtau)+v+akhima+yuq
tulagvik	tu+(la)+gv+ik
iqaluk	iq+a+lu+(k)
ikkitautikhaq	ikk+(ita)+utikh+aq
apijuq	a+(p)+i+j+uq
hulitjutikhanik	huli+(tj)+utikh+a+nik
katuun	ka+(tu)+un
spot	(spot)
taimaniraaluk	ta+(imaniraa)+lu+k
uvajurmik	uva+(jurmi)+k
piyumayut	pi+(yuma)+yut
aliagiyatka	al+i+(agiya)+tk+a
ilitugipkaiyaangat	ili+tug+ip+k+(ai)+yaang+at
im’run	(im’r)+un
pinahuarutait	pi+nahu+ar+u+(ta)+it
aluktuqtuq	a+lu+(ktu)+qtuq
timi	ti+(mi)
ungalliq	ung+a+(lli)+q
kingulirni	king+ul+(ir)+ni
imiqtaa	(imi)+qtaa
katuut	ka+(tu)+ut
uqarvigijaa	uqa+(rvi)+gijaa
akilliq	aki+(lli)+q
tuniyauhimayut	tu+ni+(yau)+hima+yut
qakuqtaq	qa+ku+(q)+taq
havagvianun	hav+a+gv+(i)+anu+n
higaakuvik	hig+aa+(ku)+vi+k
ihivjuktuq	(ihivju)+kt+uq
iqqakuuq	iqqaku+u+(q)
kigiqtuq	ki+(gi)+qtuq
kii	ki+(i)
paanruliaq	pa+(anruli)+aq
nalvaalairamik	(nalva)+al+aira+mik
qilirniq	q+ili+rn+(i)+q
nunatsiarmi	nuna+(tsi)+armi
akukittuq	ak+u+(k)+ittuq
aulajjut	aula+(jju)+t
atuqpallaarnainnikkut	at+u+(qpallaarnain)+nik+kut
tuniutiyaangat	tu+ni+(uti)+yaang+at
angiglipkarlutik	angi+(gli)+pkar+lutik
hila	hi+(la)
hivulliq	hivul+li+(q)
iigijuq	i+(igi)+j+uq
tamainnik	ta+(ma)+in+nik
aajjikkutavjaini	aajj+ikk+uta+(vja)+i+ni
hitaakiq	hita+aki+(q)
ihiqigaji	ihi+qi+(ga)+ji
nipaluk	n+ip+(a)+lu+k
taliqpimni	t+al+(iqpi)+mn+i
aappak	a+(appa)+k
kapihilik	ka+(pihi)+lik
http	h+(ttp)
aviktuqhimayuni	av+ikt+u+(q)+himayun+i
atuqlunilu	at+u+(q)+lu+nilu
nauna	naun+(a)
uilgarniq	u+(ilga)+r+niq
nukaq	nu+(k)+aq
aannaktuliqiyikullu	a+an+n+(aktu)+liq+iyik+ullu
upalungaiyautitlu	u+pa+(lungaiya)+utit+lu
aulapkainikkut	aula+pka+(i)+nik+kut
ikualaaqtuliqinirmut	iku+al+a+(aqtu)+liq+inir+mut
niruangmata	ni+ru+a+(ngma)+ta
ata	a+(ta)
ikayuutikhanik	ik+ayu+(utikha)+nik
auladjutitik	aula+dj+ut+(i)+tik
iluvrit	ilu+v+(ri)+t
kivgaqtui	kivgaq+tu+(i)
kapukhilimaittuq	ka+pu+(khi)+lima+ittuq
apurvikhaqhiuqtuq	apur+v+(ikhaqhi)+u+qtuq
aputi	ap+(uti)
aanniaqtuq	a+an+n+(i)+a+qtuq
ulapkipkaidjutinik	ul+ap+ki+pka+(idj)+uti+nik
makpigaliugaqnut	makp+(igaliu)+gaq+nut
nilfa	ni+(lfa)
pivikhaqautitkut	pi+(vikhaqauti)+tkut
ukharjuk	u+(kh)+ar+ju+k
nanminikkut	na+nmin+(i)+kkut
naunaitkuhiqtaa	na+una+it+(kuhi)+qtaa
qaritauyamilu	qa+ritauya+(milu)
amgiaqhuutiqaqqan	amgiaq+hu+(utiqaq)+qa+n
aqilgivik	aqil+(gi)+vi+k
kuhiqtaqtuq	ku+(hiqt)+a+qtuq
aqiaruijaqtaa	a+qi+aru+(ija)+qtaa
kivgaqtuidjutikhanut	kivgaq+tu+(idjut)+ik+ha+nut
ikuhingmingaaqtuq	iku+(hingminga)+a+qtuq
qugluktuq	qu+(glu)+kt+uq
tiritquq	tiri+(tqu)+q
miqhuqtaa	mi+(qhu)+qtaa
talukujaaq	ta+lu+(kuja)+aq
anaq	a+(na)+q
laisikhainnik	lais+(ikha)+in+nik
nuutaanguqtiqhugit	nu+uta+ang+(uqtiq)+hu+git
hatqummiqhijuq	ha+tqu+mmi+(qhi)+j+uq
aalliak	aall+(i)+ak
nirritit	ni+(rriti)+t
aulatjutitit	aula+t+j+ut+(iti)+t
qanurittuni	qa+nur+(ittu)+ni
havakvik	hav+ak+(vi)+k
ingilradjutikhanik	i+ngi+(lradj)+utikh+a+nik
pigaaqtuq	pi+(ga)+a+qtuq
naunaipkuhiqtaa	na+una+ip+k+(uhi)+qtaa
millalauqtuq	mi+(llala)+u+qtuq
qalluti	qa+ll+(uti)
nukariit	nu+(kari)+it
mikinnuarjuk	miki+(nnu)+ar+ju+k
quriiqtaq	qu+(riiq)+taq
aluijarvik	a+lu+(ija)+rvik
nipin’ngajuq	n+ip+(in’)+nga+juq
uqamiluktuq	uqa+(milu)+kt+uq
akiraqtuqtuq	aki+ra+(qtu)+qtuq
pihiq	pi+(hi)+q
malrijuq	mal+(r)+i+j+uq
ammak	a+(mma)+k
nuvujalaqijuq	nuvu+(j)+alaqi+juq
aumait	auma+(i)+t
ublukittuq	ub+lu+(ki)+tt+uq
manikhamingnik	man+ik+ha+(mi)+ng+nik
naunaitkutikhamik	naun+ai+(tku)+t+ikha+mik
qilak	qi+(la)+k
inungnulu	inu+(ngnu)+lu
piqutini	pi+(q)+uti+ni
uliktaa	u+(li)+kt+a+a
aarlungajuq	a+(arlu)+nga+juq
hiqanaakhiun	hiqan+a+a+k+hi+(un)
tupiq	tu+p+(i)+q
paipaut	pa+(ipa)+ut
ilaranaittuq	i+(larana)+ittuq
qaritauyaliqidjutingit	qa+r+it+auyal+iq+(idjut)+i+ngit
ilaruhiq	i+la+(ruhi)+q
kublu	ku+(blu)
aunginnannguqtuq	a+(ung)+in+nanngu+qtuq
pijumajuq	p+ij+u+(ma)+j+uq
pingahuuyut	pi+(ngahu)+uyut
hangujuq	ha+(ngu)+j+uq
qiqaujuq	qi+(qa)+u+juq
aqittuq	a+(q)+ittuq
aqpattuq	a+(qpa)+tt+uq
kappuutit	ka+(ppuut)+it
aikhiutijaa	(aikhi)+utijaa
hinaaguuqtuq	hi+na+(aguu)+qtuq
nurrakhaq	nur+ra+(kh)+aq
titirauyaqhimanikkullu	tit+irauya+(qhima)+nik+kul+lu
umayuliqiyitkuni	(umayu)+liq+iyit+ku+ni
aittuutikhat	a+(ittu)+utikh+at
kitautiqtuq	ki+(taut)+i+qtuq
naammaktuq	naamma+(ktu)+q
auviuqtuq	(auvi)+u+qtuq
taijuq	ta+(i)+j+uq
uqallautivaklugit	uqa+(lla)+uti+vak+lu+git
timigiyaat	ti+(migiya)+at
hunngittuq	(hu)+nng+ittuq
uqaqti	uq+aqt+(i)
aalliraq	aall+(ir)+aq
aulajjun	aula+(jju)+n
iniruajuq	ini+(rua)+j+uq
taqtu	ta+(qtu)
ahiaq	a+(hi)+aq
nguyat	(nguya)+t
nutiblik	nu+(tib)+lik
hunamik	hu+na+(mi)+k
qanuq taivakpiuk	qa+(nuq )+tai+vak+pi+uk
qipijaa	qi+(pi)+jaa
naitumik	na+(i)+tu+mik
tujami	tu+(ja)+mi
apittiujuq	a+pit+(ti)+u+juq
nutanguqtiqninik	n+uta+(ngu)+qtiq+ni+nik
ijarluktuq	i+(jarlu)+kt+uq
majuraqtuq	ma+j+u+(ra)+qtuq
kapijaa	ka+(pi)+jaa
nuuttuq	nu+(u)+tt+uq
nunamiitilutin	nuna+(miiti)+lutin
ajuqtuq	a+(ju)+qtuq
nakahua	na+ka+(hua)
humungauliqtunik	hum+ung+(au)+liq+tu+nik
tangmaarnikkutlu	t+ang+ma+(ar)+nik+kut+lu
ikaaknikharnik	ik+a+ak+(ni)+khar+nik
qanniqtuq	qa+(nni)+qtuq
iquutikhauti	i+qu+(utikha)+uti
havaktukharnik	hav+akt+(u)+khar+nik
tamatkirahuaqhugit	t+ama+(tkirahuaq)+hu+git
abluqtuq	a+(blu)+qtuq
angajugiit	ang+aju+(gi)+it
ainnuaq	a+(innu)+aq
ungahiktumit	ung+a+(hiktumi)+t
utirniaqtutin	u+(tir)+ni+aqtu+t+in
agluraqtuq	a+glu+(r)+a+qtuq
aaniqtailiniqmut	a+a+niq+ta+(ili)+niq+mut
aluaq	a+lu+(a)+q
hitaman	(hitama)+n
iglaqtittijuq	igl+a+(qtitti)+j+uq
ih	i+(h)
kapurhirvia	k+apur+hirv+(ia)
niuvvaajuq	ni+uv+(vaa)+j+uq
katimayuarutmi	kat+ima+(yuar)+ut+mi
ingilraan	i+ngi+(lraa)+n
pivalliadjutikhainik	pi+vall+i+(adj)+utikh+a+i+nik
qiviaqtuq	qi+(via)+qtuq
aunaaqtuq	a+(una)+a+qtuq
hikuuti	hi+(ku)+uti
imiaqtuq	im+(i)+a+qtuq
tulrujuq	tu+(lru)+j+uq
aallaunahugijaa	aall+a+(unahu)+gijaa
tuniqhaktaujuq	tu+n+(iqhakta)+u+juq
iihijuq	i+(ihi)+j+uq
aatituuqtuq	aatitu+(u)+qtuq
akit	a+(k)+it
aqiaruq	a+qi+aru+(q)
tikinnatik	t+iki+(nna)+tik
tamna	(ta)+mna
akiliqtaa	ak+ili+(q)+taa
naniriaq	na+(ni)+riaq
pivikhaqautikkutlu	pi+(vikhaqauti)+kkut+lu
hapkunani	ha+p+(kun)+ani
kapijuq	ka+(p)+i+j+uq
naunaiyarniit	naun+a+iya+(rni)+it
munarinikkut	mu+na+(r)+inikk+ut
ihuarutikharnik	i+hu+(a)+r+utikh+ar+nik
ivjujuq	ivj+(u)+j+uq
unaluunniit	(una)+lu+unni+it
aallangajuq	a+(alla)+nga+juq
qin’ngurluktuq	qin+’ng+(urlu)+kt+uq
tablu	ta+(blu)
piyaangat	p+(i)+yaang+at
niqikhailliuqhutik	niq+ikh+(ailliuq)+hu+tik
qihigalik	qi+(higa)+lik
munarinikutlu	mu+na+(ri)+nik+utlu
qanuriliurutainnilu	qa+nur+(iliur)+utain+nilu
iliuraiyut	ili+(ura)+iyut
itqumavaquyut	it+qu+(mavaq)+uyut
ikayugianganik	ik+ayu+(gianga)+nik
pivallialiuqpaktuq	pi+vall+i+(aliuqpa)+kt+uq
havagiaqaqtaingit	hav+a+(giaq)+aq+tai+ngit
taktaa	t+ak+(ta)+a
tagjuqtuq	ta+(gju)+qtuq
qajainnaq	(qaja)+in+naq
hiluraqtuq	(hilura)+qtuq
kigutigikhaun	kigut+(igikha)+un
pulaarnirmik	pu+(la)+ar+nir+mik
napaaqtuq	na+(pa)+a+qtuq
aannikhaaqtautikhanik	a+an+n+(ikhaaqta)+utikh+a+nik
iliugailugu	ili+(ugai)+lu+gu
iggiarniluuniit	ig+(giar)+nilu+uniit
arcs	a+(rcs)
katimayiita	kat+ima+(yii)+ta
havaatigut	ha+(va)+at+igut
ahiani	a+(hi)+ani
tattivaluillu	ta+tt+(ivalu)+il+lu
atilingmik	at+ili+(ngmi)+k
kannujaq	ka+(nn)+uja+q
tuhagakhaliriyi	tu+hag+akh+al+(iriyi)
aanniqtuq	a+an+n+(i)+qtuq
ajuqhittuq	aju+(qhi)+tt+uq
inuaqtaujuq	inu+(aqta)+u+juq
october	octobe+(r)
qigliktaqtuq	qi+(gli)+kta+qtuq
nauktaimna	na+(uk)+tai+mna
unaguqtaiqhajait	una+guqta+iq+ha+ja+(i)+t
tukhiqtainni	t+uk+(hiqta)+in+ni
tunihimaaqtunlu	tu+ni+(hima)+aqtun+lu
pivikhainnut	pi+(vi)+kha+in+nut
puvittuq	pu+(vi)+tt+uq
qamauk	qa+(ma)+uk
kingloon	ki+(ngloo)+n
nappaqtirnirmi	na+pp+aqt+(ir)+nir+mi
amaamauti	a+(maama)+uti
atiqtuq	a+(ti)+qtuq
hiun	(hi)+un
puijuq	pu+(i)+j+uq
kanajuraq	ka+na+(ju)+raq
paja	pa+(ja)
ihivriuqtukharnik	ihivr+i+(uqtu)+khar+nik
ihumajuq	i+hu+(ma)+j+uq
ikitaa	i+(ki)+taa
inuinnarnun	inuinna+(r)+n+un
anmuktaa	an+(mu)+kt+a+a
angitqiyamik	angi+(tqiya)+mik
inuinnaqtun	inuinna+(qtu)+n
iglu	(iglu)
iqhigijaa	i+(qhi)+gijaa
itquumayut	it+qu+(umayu)+t
uqaallautijaa	uqa+(alla)+utijaa
ilakuit	i+la+(ku)+it
puukattaq	pu+u+(katta)+q
amaut	a+(ma)+ut
uqquujuq	uq+qu+(u)+j+uq
munagiyukhat	mu+na+(gi)+yu+khat
piniraq	pi+(ni)+raq
nipiliuti	n+ip+(ili)+uti
tagjaaq	ta+(gja)+aq
mabel	ma+(bel)
ulapqidjutauvaktut	ul+apq+(idjutau)+vak+tut
nunijuq	nu+(n)+i+j+uq
uingajuq	u+(i)+nga+juq
aumaallaktuq	auma+(alla)+kt+uq
pitquhirnikkut	pit+q+uhi+(r)+nik+kut
tutqukhimayunik	tutqu+(k)+hima+yu+nik
apihimajuq	a+(pi)+hi+majuq
aniqhaumijaaqtuq	a+niq+ha+(umi)+jaa+qtuq
nivinngaqtaa	n+ivi+(nnga)+qtaa
takpiittuq	t+ak+(pi)+ittuq
anguaqtuq	a+(ngu)+a+qtuq
havaktiyukharnik	hav+akt+(i)+yu+khar+nik
niuqqaqtuq	ni+u+(qqa)+qtuq
havaktakhat	hav+akt+(a)+khat
pivalliadjutikhaniklu	pi+vall+i+(adj)+utikh+a+nik+lu
utirvikharnik	(uti)+rvi+khar+nik
qalahiq	qa+l+(ahi)+q
iliranaqtuq	ilira+(na)+qtuq
tuktunik	tu+(ktu)+nik
manikharvikhaq	man+ik+ha+(rvi)+khaq
aqiaviniq	aq+ia+(vi)+niq
hanimun	h+an+(i)+m+un
qitiqhiq	q+iti+(qhi)+q
tikinnahi	t+iki+(nna)+hi
haniani	ha+(ni)+ani
ilaali	i+la+(ali)
algaujaq	alg+(a)+uja+q
iepngitni	(iep)+ngit+n+i
hivayautiqaqtut	hivay+a+(utiqaq)+tut
ikhivajuq	ik+hiv+(a)+j+uq
ikkitit	ikk+(it)+it
nipiliuruti	n+ip+(iliur)+uti
attatak	att+(ata)+k
niuvuritkhaliqiyitkut	ni+uv+(uritkha)+liq+iyit+kut
aivirniglu	a+ivi+(rni)+g+lu
ublaami	ub+(la)+a+mi
ilihairutingnik	ili+ha+(ir)+ut+ingn+ik
havauhikhanik	hav+a+(uhi)+k+ha+nik
kingmingnak	k+ing+mi+(ngna)+k
havviqun	hav+(vi)+q+un
maniliqiryiryuangit	man+ili+q+(iryiryu)+a+ngit
aquti	a+(q)+uti
majurautit	majuraut+(i)+t
emo	em+(o)
situa	si+tu+(a)
haqiktaut	ha+(qikta)+ut
iharuq	(iharu)+q
in’rutaq	i+(n’r)+ut+aq
makitalviani	ma+ki+ta+(lvi)+ani
nunavunmiut	nuna+(vunmi)+ut
umanga	(uma)+nga
minguliq	mingul+(i)+q
atugiangat	at+u+(gianga)+t
paamnguliaq	pa+(amnguli)+aq
pilakaalaaqtan	pil+ak+a+ala+(aqta)+n
qimujuittuq	qi+(mu)+ju+ittuq
maligutinik	mal+i+(g)+uti+nik
tahitaa	ta+(hi)+taa
unnirluktuq	un+n+(irlu)+kt+uq
nakuugijaa	nakuu+(gi)+jaa
arvaaq	(arva)+aq
havagvik	hav+a+gv+(ik)
malruiqtuqtuq	malru+(iqt)+u+qtuq
hunamiaqtuq	hu+na+(mi)+a+qtuq
nunauyaqmiklu	nuna+(uy)+aq+mik+lu
hiujjarluktuq	hi+ujja+(rlu)+kt+uq
anngun	a+(nngu)+n
nigaq	(ni)+gaq
uqhurjuaqtauti	uqhurjua+(qtau)+ti
qaffiunik	qa+(ffiu)+nik
apqutaittuq	apq+ut+(a)+ittuq
havagviinik	hav+a+gv+(i)+i+nik
hiujjariktuq	hi+ujja+(ri)+kt+uq
tuhaqtaa	tu+(ha)+qtaa
havangtinnagit	hav+ang+(tinna)+git
imannaaqtuq	ima+(nna)+a+qtuq
nakuudjutikhainnutlu	nakuu+(djuti)+kha+in+nut+lu
hikutirvia	h+iku+(ti)+rvi+a
ilihaqpaliknikkut	ili+ha+(qpalik)+nik+kut
ilitturipkaidjutikhanut	ili+t+turip+ka+(idjut)+ik+ha+nut
kangikhimayakhainiklu	ka+ngi+(khima)+ya+khai+nik+lu
imiqtaqti	(imiqta)+qti
iqaluktuutiaq	iqa+luk+(tuuti)+aq
kihaq	ki+(ha)+q
kujaktuq	(kuja)+kt+uq
mitquq	mitqu+(q)
atuqttukhani	at+uqt+(tukh)+ani
pidjutikhanut	p+idjut+(i)+kha+nut
pualriti	pu+alri+(ti)
havakviat	hav+ak+(via)+t
aannialiqtailitikhaniklu	a+an+n+(ialiqtailit)+ikha+nik+lu
havaktauyukhami	hav+akt+(auyukh)+a+mi
naunaikutinikkut	naun+ai+(kut)+inikk+ut
aajuraq	a+(aju)+raq
himmauhiqtaa	h+imma+(uhi)+qtaa
natiruvilaqijuq	natir+uv+(ilaq)+i+j+uq
tahiq	ta+(hiq)
utkuhikhaq	ut+(kuhi)+khaq
pulaaqtuq	pu+(la)+a+qtuq
tingmiaq	tingmi+(a)+q
itqumayumik	itq+(umayu)+mik
taimak	t+a+i+ma+(k)
aviktuqvingniitunik	aviktuqving+n+(ii)+tu+nik
kiinaruq	ki+ina+(ru)+q
havakvianggatni	hav+ak+(vianggat)+ni
kivgaqtuqtuq	kivgaq+tu+(qtu)+q
kiguhiqijuq	ki+guhi+(q)+i+j+uq
taima	ta+i+(ma)
hamma	ha+(mma)
tammaqtuq	ta+(mma)+qtuq
aulapkaidjutimut	aula+pka+(idj)+uti+mut
havauhiqaqtun	hav+a+(uhiq)+aqtun
unnukpan	un+n+(ukpan)
kakkiijauti	ka+(kkiija)+uti
iliharvigijaa	i+li+ha+(rvi)+gijaa
aajjigijaa	a+(ajjig)+i+jaa
hakugingnikhaamutlu	haku+(gi)+ngni+kha+a+mut+lu
mihingnautait	mihi+(ngna)+u+ta+it
mitiq	mi+(ti)+q
talvuuna	ta+lv+(uuna)
angirutiqaqhimayunik	ang+ir+(utiqaq)+hima+yu+nik
takkuuk	ta+(kku)+uk
naarliqtuq	na+(ar)+li+qtuq
hivuniqhipkaqtaa	hivun+iqh+(ipka)+qtaa
haviqquujaq	hav+(iqqu)+uja+q
ihivriuqhijuq	ihivr+i+(uqhi)+j+uq
higaarluktuq	hig+aa+(rlu)+kt+uq
angajuk	ang+aju+(k)
iniqhimayumik	ini+(q)+hima+yu+mik
hunauva	hu+na+(uva)
qikaaqtuq	qi+(ka)+a+qtuq
utimun	u+(ti)+m+un
ikayuutikhallu	ik+ayu+(utikha)+llu
uaqtaa	(u)+a+qtaa
umilruk	u+mi+(lru)+k
nauviktut	n+(auvi)+kt+ut
pijjarluktuq	pi+(jjarlu)+kt+uq
ihumaliurnirmut	i+hu+(maliur)+ni+rm+ut
arnaqtuqtuq	arna+(qtu)+qtuq
ataatattiaq	a+ta+a+ta+(tti)+aq
allaqhijuq	a+ll+(aqhi)+j+uq
ujarak	(ujar)+ak
tigluut	ti+(glu)+ut
hiqiniq	hi+(q)+in+iq
irmiuti	(irmi)+uti
maligaliurvingmi	mal+(igaliu)+rvi+ngmi
munakhivaktut	mu+na+(khi)+vak+tut
tajjagu	ta+(jja)+gu
ipummingajuq	ip+(ummi)+nga+juq
mto	(mto)
qallut	qa+ll+(ut)
ilitturipkaitjutnik	ili+t+turip+ka+(itjut)+nik
tamaaniluunniit	t+ama+(a)+nilu+un+ni+it
avin’ngaq	avi+(n’ng)+aq
nunaqatigiptingnut	nuna+(qatigi)+pting+nut
nipittaaqtuq	ni+pit+(ta)+a+qtuq
tuhujuq	(tuhu)+j+uq
utkuhik	ut+(kuhi)+k
pangnaarjuk	pa+(ngna)+ar+ju+k
aulavikhainni	aula+(vi)+kha+in+ni
pilihaarniq	pi+(lihaar)+niq
halumaittuq	ha+(luma)+ittuq
atuqtaa	a+(tu)+qtaa
qanuqakituvaaa	qan+(uq)+akitu+v+a+a+a
tuphijuq	tu+(phi)+j+uq
mmaamak	m+(maama)+k
hivumuuriaminik	hiv+um+uu+(riam)+i+nik
tipigikhaun	tip+(igikha)+un
qalvaaq	qa+l+(va)+aq
pangniq	pa+ng+(ni)+q
brent	(bren)+t
paunngaq	pa+(unng)+aq
tiiliurvik	ti+(iliur)+vi+k
uaqtiqtuq	u+(aqti)+qtuq
taktuktuq	ta+(ktu)+kt+uq
qinngijuq	qi+(nng)+i+j+uq
havakviangit	hav+ak+(vi)+a+ngit
umngijaqtuq	(umngija)+qtuq
ajurnarmat	aju+(rna)+rma+t
tunuhitaq	tu+n+(uhi)+taq
qanuqtaivakpiuk	qan+(uq)+tai+vak+pi+uk
aqu	a+(qu)
